अ	a
अँखिया	ankhiya
अँखौड़ा	ankhauda
अँगना	angana
अँगरखा	angarakha
अँगरेजी	angarejee
अँगरेजों	angarejon
अँगरेज़	angarez
अँगरेज़ी	angarezee
अँगिया	angiya
अँगीकार	angeekaar
अँगीठी	angeethee
अँगुलियाँ	anguliyaan
अँगुलियों	anguliyon
अँगुली	angulee
अँगूठा	angootha
अँगूठी	angoothee
अँगूठे	angoothe
अँग्रेजी	angrejee
अँग्रेजी़	angrejee
अँग्रेजों	angrejon
अँग्रेज़ी	angrezee
अँग्रेज़ों	angrezon
अँगड़ाई	angadaee
अँठली	anthalee
अँडुआ	andua
अँतड़ी	antadee
अँधियारा	andhiyaara
अँधेरा	andhera
अँधेरी	andheree
अँधेरे	andhere
अंक	ank
अंकगणित	ankaganit
अंकगणितीय	ankaganiteey
अंकगत	ankagat
अंकटाड	ankataad
अंकन	ankan
अंकनी	ankanee
अंकनीय	ankaneey
अंकपत्र	ankapatr
अंकरूपक	ankaroopak
अंकल	ankal
अंकारा	ankaara
अंकावतार	ankaavataar
अंकित	ankit
अंकिता	ankita
अंकीकरण	ankeekaran
अंकीकृत	ankeekrt
अंकीय	ankeey
अंकुर	ankur
अंकुरक	ankurak
अंकुरण	ankuran
अंकुरित	ankurit
अंकुरों	ankuron
अंकुश	ankush
अंकुशाकार	ankushaakaar
अंकेक्षक	ankekshak
अंकेक्षण	ankekshan
अंकेक्षित	ankekshit
अंको	anko
अंकों	ankon
अंकोरवाट	ankoravaat
अंखफोड़वा	ankhaphodava
अंग	ang
अंगछेद	angachhed
अंगछेदन	angachhedan
अंगद	angad
अंगना	angana
अंगरक्षक	angarakshak
अंगरक्षकों	angarakshakon
अंगरखा	angarakha
अंगराग	angaraag
अंगरागता	angaraagata
अंगरागविज्ञान	angaraagavigyaan
अंगरागों	angaraagon
अंगरेजी	angarejee
अंगरेजों	angarejon
अंगरेज़	angarez
अंगरेज़ी	angarezee
अंगवाला	angavaala
अंगविच्छेद	angavichchhed
अंगशैथिल्य	angashaithily
अंगहीन	angaheen
अंगा	anga
अंगार	angaar
अंगारा	angaara
अंगारे	angaare
अंगारों	angaaron
अंगाषाश्म	angaashaashm
अंगिका	angika
अंगिया	angiya
अंगिरस	angiras
अंगिरा	angira
अंगीकरण	angeekaran
अंगीकार	angeekaar
अंगीकृत	angeekrt
अंगीठी	angeethee
अंगीभूत	angeebhoot
अंगुठी	anguthee
अंगुत्तर	anguttar
अंगुल	angul
अंगुलबेढ़ा	angulabedha
अंगुलाग्र	angulaagr
अंगुलि	anguli
अंगुलित्र	angulitr
अंगुलिनिर्देश	angulinirdesh
अंगुलियाँ	anguliyaan
अंगुलियों	anguliyon
अंगुलिहीन	anguliheen
अंगुलिहीनता	anguliheenata
अंगुली	angulee
अंगुश्त	angusht
अंगुश्तनुमा	angushtanuma
अंगुश्ताना	angushtaana
अंगुष्ठ	angushth
अंगूठा	angootha
अंगूठियों	angoothiyon
अंगूठी	angoothee
अंगूठे	angoothe
अंगूठों	angoothon
अंगूर	angoor
अंगूरी	angooree
अंगूरों	angooron
अंगो	ango
अंगों	angon
अंगोच्छेदन	angochchhedan
अंगोछना	angochhana
अंगोछा	angochha
अंगोरा	angora
अंगोरा	angora
अंगोला	angola
अंग्रजी	angrajee
अंग्रजों	angrajon
अंग्रेज	angrej
अंग्रेजी	angrejee
अंग्रेजी़	angrejee
अंग्रेजो	angrejo
अंग्रेजों	angrejon
अंग्रेज़	angrez
अंग्रेज़ियत	angreziyat
अंग्रेज़ी	angrezee
अंग्रेज़ो	angrezo
अंगड़ाई	angadaee
अंचल	anchal
अंचलों	anchalon
अंजन	anjan
अंजनहारी	anjanahaaree
अंजना	anjana
अंजनी	anjanee
अंजलि	anjali
अंजली	anjalee
अंजान	anjaan
अंजाने	anjaane
अंजाम	anjaam
अंजीर	anjeer
अंजुम	anjum
अंजुमन	anjuman
अंजू	anjoo
अंटा	anta
अंटार्कटिक	antaarkatik
अंटार्कटिका	antaarkatika
अंटार्टिका	antaartika
अंटी	antee
अंड	and
अंडकोश	andakosh
अंडकोष	andakosh
अंडकोषीय	andakosheey
अंडखोल	andakhol
अंडप	andap
अंडमान	andamaan
अंडमानी	andamaanee
अंडर	andar
अंडरआर्म	andaraarm
अंडरएक्स्पोज़	andarekspoz
अंडरग्राउंड	andaragraund
अंडरटेकर	andaratekar
अंडरटेकिंग	andarateking
अंडरपास	andarapaas
अंडरवर्ल्ड	andaravarld
अंडरवियर	andaraviyar
अंडरवुड	andaravud
अंडरस्कोर्स	andaraskors
अंडरस्टैंडिंग	andarastainding
अंडसमूह	andasamooh
अंडा	anda
अंडाकार	andaakaar
अंडाणु	andaanu
अंडाशय	andaashay
अंडे	ande
अंडों	andon
अंडोरा	andora
अंत	ant
अंतः	antah
अंतःकरण	antahkaran
अंतःक्रिया	antahkriya
अंतःक्षेत्र	antahkshetr
अंतःक्षेपण	antahkshepan
अंतःपुर	antahpur
अंतःविषय	antahvishay
अंतःशिरा	antahshira
अंतःसंबंध	antahsambandh
अंतःसम्पर्क	antahsampark
अंतःसर्पी	antahsarpee
अंतःसागरी	antahsaagaree
अंतःस्त्राव	antahstraav
अंतःस्थल	antahsthal
अंतःस्थलीय	antahsthaleey
अंतःस्राव	antahsraav
अंतःस्रावी	antahsraavee
अंतक	antak
अंतकाल	antakaal
अंतत	antat
अंततः	antatah
अंततोगत्वा	antatogatva
अंतनिर्हित	antanirhit
अंतभाग	antabhaag
अंतर	antar
अंतरंग	antarang
अंतरंगता	antarangata
अंतरंगी	antarangee
अंतरगत	antaragat
अंतरग्रहण	antaragrahan
अंतरजातीय	antarajaateey
अंतरजाल	antarajaal
अंतरण	antaran
अंतरतम	antaratam
अंतरतारकीय	antarataarakeey
अंतरपणन	antarapanan
अंतरफलक	antaraphalak
अंतरबैंक	antarabaink
अंतरमहाद्वीपीय	antaramahaadveepeey
अंतरराज्यीय	antararaajyeey
अंतरराष्ट्रीय	antararaashtreey
अंतरराष्ट्रीयकरण	antararaashtreeyakaran
अंतरर्राष्ट्रीय	antararraashtreey
अंतरस्थ	antarasth
अंतरा	antara
अंतरात्मा	antaraatma
अंतरापर्वतीय	antaraaparvateey
अंतरापृष्ठ	antaraaprshth
अंतराय	antaraay
अंतराल	antaraal
अंतरालरहित	antaraalarahit
अंतरालों	antaraalon
अंतराष्ट्रीय	antaraashtreey
अंतरिक	antarik
अंतरिक्ष	antariksh
अंतरिक्षचारी	antarikshachaaree
अंतरिक्षयात्री	antarikshayaatree
अंतरिक्षयान	antarikshayaan
अंतरिक्षविज्ञानशास्री	antarikshavigyaanashaasree
अंतरिक्षीय	antariksheey
अंतरित	antarit
अंतरिम	antarim
अंतरिमकाल	antarimakaal
अंतरीप	antareep
अंतरीय	antareey
अंतरों	antaron
अंतर्कार्यालयीन	antarkaaryaalayeen
अंतर्कालीन	antarkaaleen
अंतर्क्रिया	antarkriya
अंतर्गत	antargat
अंतर्ग्रस्त	antargrast
अंतर्ग्रहण	antargrahan
अंतर्ग्रहण्	antargrahan
अंतर्ग्राहिक	antargraahik
अंतर्जंघिका	antarjanghika
अंतर्जनस्तर	antarjanastar
अंतर्जात	antarjaat
अंतर्जातीय	antarjaateey
अंतर्जाल	antarjaal
अंतर्ज्ञान	antargyaan
अंतर्ज्ञेयवाद	antargyeyavaad
अंतर्तम	antartam
अंतर्तारकीय	antartaarakeey
अंतर्दर्शन	antardarshan
अंतर्दहन	antardahan
अंतर्दृष्टि	antardrshti
अंतर्देशीय	antardesheey
अंतर्द्वंद	antardvand
अंतर्धान	antardhaan
अंतर्धारा	antardhaara
अंतर्निहित	antarnihit
अंतर्मन	antarman
अंतर्महाद्वीपीय	antarmahaadveepeey
अंतर्मुखता	antarmukhata
अंतर्मुखी	antarmukhee
अंतर्यामी	antaryaamee
अंतर्राज्यीय	antarraajyeey
अंतर्राष्ट्रवादी	antarraashtravaadee
अंतर्राष्ट्रीकरण	antarraashtreekaran
अंतर्राष्ट्रीय	antarraashtreey
अंतर्राष्ट्रीयकरण	antarraashtreeyakaran
अंतर्राष्ट्रीयता	antarraashtreeyata
अंतर्राष्ट्रीयतावाद	antarraashtreeyataavaad
अंतर्राष्ट्रीयतावादी	antarraashtreeyataavaadee
अंतर्रोधी	antarrodhee
अंतर्वर्ती	antarvartee
अंतर्वस्तु	antarvastu
अंतर्वस्त्र	antarvastr
अंतर्वाह	antarvaah
अंतर्वाही	antarvaahee
अंतर्विभागीय	antarvibhaageey
अंतर्विराम	antarviraam
अंतर्विरोध	antarvirodh
अंतर्विवाह	antarvivaah
अंतर्विवाही	antarvivaahee
अंतर्विषयक	antarvishayak
अंतर्वेश	antarvesh
अंतर्वेशन	antarveshan
अंतर्संबंधों	antarsambandhon
अंतश्छद	antashchhad
अंतहीन	antaheen
अंतहीनता	antaheenata
अंताल्या	antaalya
अंतिम	antim
अंतिमबिंदु	antimabindu
अंतिमांश	antimaansh
अंतेवासी	antevaasee
अंतोनियो	antoniyo
अंत्य	anty
अंत्यलक	antyalak
अंत्याधार	antyaadhaar
अंत्यानुप्रास	antyaanupraas
अंत्यानुप्रासवाला	antyaanupraasavaala
अंत्येष्टि	antyeshti
अंत्र	antr
अंत्रवृद्धि	antravrddhi
अंतड़ियां	antadiyaan
अंतड़ियों	antadiyon
अंतड़ी	antadee
अंदर	andar
अंदरुनी	andarunee
अंदरूनी	andaroonee
अंदाज	andaaj
अंदाजा	andaaja
अंदाज़	andaaz
अंदाज़ा	andaaza
अंदेशा	andesha
अंधक	andhak
अंधकार	andhakaar
अंधकारपूर्ण	andhakaarapoorn
अंधकारपूर्णता	andhakaarapoornata
अंधकारभीति	andhakaarabheeti
अंधकारमय	andhakaaramay
अंधक्षेत्र	andhakshetr
अंधड	andhad
अंधता	andhata
अंधभक्त	andhabhakt
अंधभक्ति	andhabhakti
अंधविश्वास	andhavishvaas
अंधविश्वासी	andhavishvaasee
अंधविश्वासों	andhavishvaason
अंधश्रद्धा	andhashraddha
अंधा	andha
अंधाधुंध	andhaadhundh
अंधाधुध	andhaadhudh
अंधाधुन्ध	andhaadhundh
अंधानुकरण	andhaanukaran
अंधापन	andhaapan
अंधियारा	andhiyaara
अंधी	andhee
अंधे	andhe
अंधेर	andher
अंधेरा	andhera
अंधेरापन	andheraapan
अंधेरी	andheree
अंधेरे	andhere
अंधों	andhon
अंधड़	andhad
अंपायर	ampaayar
अंपायरिंग	ampaayaring
अंबर	ambar
अंबरीश	ambareesh
अंबा	amba
अंबानी	ambaanee
अंबार	ambaar
अंबाला	ambaala
अंबिका	ambika
अंबिकापुर	ambikaapur
अंबुज	ambuj
अंबुपति	ambupati
अंबेडकर	ambedakar
अंश	ansh
अंशअ	ansh
अंशकालिक	anshakaalik
अंशकालीन	anshakaaleen
अंशछादन	anshachhaadan
अंशजलीय	anshajaleey
अंशत	anshat
अंशतः	anshatah
अंशदाता	anshadaata
अंशदान	anshadaan
अंशदायी	anshadaayee
अंशधारियों	anshadhaariyon
अंशधारी	anshadhaaree
अंशबोधक	anshabodhak
अंशभागी	anshabhaagee
अंशशोधन	anshashodhan
अंशस्वामी	anshasvaamee
अंशांकन	anshaankan
अंशांकित	anshaankit
अंशातिप्रिय	anshaatipriy
अंशिका	anshika
अंशु	anshu
अंशुक	anshuk
अंशुमन	anshuman
अंशुमान	anshumaan
अंशुमाली	anshumaalee
अंशों	anshon
अंशोच्छेदन	anshochchhedan
अंसकूट	ansakoot
अंसपेशी	ansapeshee
अंसारी	ansaaree
अंसीय	anseey
अः	ah
अइसे	aise
अई	aee
अउर	aur
अऋतुक्षरित	artuksharit
अऔरत	aaurat
अकं	akan
अकथ	akath
अकथ्य	akathy
अकबकाना	akabakaana
अकबर	akabar
अकबरपुर	akabarapur
अकबरी	akabaree
अकरकरा	akarakara
अकरण	akaran
अकरणीय	akaraneey
अकरम	akaram
अकराबाद	akaraabaad
अकर्म	akarm
अकर्मक	akarmak
अकर्मण्य	akarmany
अकर्मण्यता	akarmanyata
अकर्मी	akarmee
अकल	akal
अकलंकता	akalankata
अकलंकित	akalankit
अकलंकी	akalankee
अकलबीर	akalabeer
अकलमंदी	akalamandee
अकलात्मक	akalaatmak
अकल्प	akalp
अकल्पनाशील	akalpanaasheel
अकल्पनीय	akalpaneey
अकसर	akasar
अकसीर	akaseer
अकस्मात	akasmaat
अकस्माती	akasmaatee
अकस्मात्	akasmaat
अकहा	akaha
अकाउंट	akaunt
अकाउंटेंट	akauntent
अकाज	akaaj
अकाट्य	akaaty
अकाट्यता	akaatyata
अकाट्यतापूर्वक	akaatyataapoorvak
अकादमिक	akaadamik
अकादमियाँ	akaadamiyaan
अकादमियों	akaadamiyon
अकादमी	akaadamee
अकादेमी	akaademee
अकाधिक	akaadhik
अकाबा	akaaba
अकाम	akaam
अकारण	akaaran
अकार्बनिक	akaarbanik
अकाल	akaal
अकालप्रौढ़	akaalapraudh
अकालियों	akaaliyon
अकाली	akaalee
अकालों	akaalon
अकिंचन	akinchan
अकिंचनता	akinchanata
अकिण्वित	akinvit
अकिता	akita
अकिलीज़	akileez
अकी	akee
अकीक	akeek
अकीनी	akeenee
अकीयाई	akeeyaee
अकुल	akul
अकुला	akula
अकुलाना	akulaana
अकुलाहट	akulaahat
अकुशल	akushal
अकुशलता	akushalata
अकुशलतापूर्वक	akushalataapoorvak
अकूत	akoot
अकृत	akrt
अकृषित	akrshit
अकेडमी	akedamee
अकेला	akela
अकेलापन	akelaapan
अकेली	akelee
अकेले	akele
अकेलेपन	akelepan
अकेशिया	akeshiya
अकैडमी	akaidamee
अकॉर्डियन	akordiyan
अकोला	akola
अक्कादी	akkaadee
अक्खड़	akkhad
अक्खड़पन	akkhadapan
अक्टुबर	aktubar
अक्टूबर	aktoobar
अक्टूबरफ़ेस्ट	aktoobarafest
अक्तुबर	aktubar
अक्तूबर	aktoobar
अक्रमतः	akramatah
अक्राम्यता	akraamyata
अक्रिय	akriy
अक्रियता	akriyata
अक्रियात्मक	akriyaatmak
अक्रियावाद	akriyaavaad
अक्रियाशील	akriyaasheel
अक्रूर	akroor
अक्ल	akl
अक्लमंद	aklamand
अक्लमंदी	aklamandee
अक्लोम	aklom
अक्वेरियम	akveriyam
अक्ष	aksh
अक्षत	akshat
अक्षतंतु	akshatantu
अक्षम	aksham
अक्षमता	akshamata
अक्षमताओं	akshamataon
अक्षमतापूर्वक	akshamataapoorvak
अक्षमित	akshamit
अक्षम्य	akshamy
अक्षय	akshay
अक्षर	akshar
अक्षरग्राम	aksharagraam
अक्षरधाम	aksharadhaam
अक्षरयोजक	aksharayojak
अक्षरश	aksharash
अक्षरशः	aksharashah
अक्षरशैली	aksharashailee
अक्षरात्मक	aksharaatmak
अक्षरार्थ	aksharaarth
अक्षरेखा	aksharekha
अक्षरों	aksharon
अक्षांक्ष	akshaanksh
अक्षांश	akshaansh
अक्षांशीय	akshaansheey
अक्षांशों	akshaanshon
अक्षि	akshi
अक्षिति	akshiti
अक्षिदंत	akshidant
अक्षीय	aksheey
अक्षुण	akshun
अक्षुण्ण	akshunn
अक्षों	akshon
अक्षोभ्य	akshobhy
अक्षौहिणी	akshauhinee
अक्स	aks
अक्सर	aksar
अक्साई	aksaee
अक्सीर	akseer
अकड़	akad
अकड़न	akadan
अकड़ना	akadana
अकड़नेवाला	akadanevaala
अकड़बाज़	akadabaaz
अकड़ू	akadoo
अकड़ैत	akadait
अखंड	akhand
अखंडता	akhandata
अखंडनीय	akhandaneey
अखंडल	akhandal
अखंडित	akhandit
अखण्ड	akhand
अखण्डता	akhandata
अखण्डित्व	akhanditv
अखती	akhatee
अखबार	akhabaar
अखबारी	akhabaaree
अखबारों	akhabaaron
अखमीरी	akhameeree
अखय	akhay
अखयतीज	akhayateej
अखर	akhar
अखरना	akharana
अखरा	akhara
अखरोट	akharot
अखा	akha
अखाडा	akhaada
अखाद्य	akhaady
अखाड़ा	akhaada
अखाड़िया	akhaadiya
अखाड़े	akhaade
अखाड़ों	akhaadon
अखियाँ	akhiyaan
अखियों	akhiyon
अखिर	akhir
अखिरी	akhiree
अखिल	akhil
अखिलेन्द्र	akhilendr
अखिलेश	akhilesh
अखिलेश्वर	akhileshvar
अख्तर	akhtar
अख्तियार	akhtiyaar
अख्तियारपुर	akhtiyaarapur
अग	ag
अगंभीर	agambheer
अगणित	aganit
अगत्ती	agattee
अगन	agan
अगम	agam
अगम्य	agamy
अगर	agar
अगरचे	agarache
अगरतला	agaratala
अगरबत्ती	agarabattee
अगरिया	agariya
अगरी	agaree
अगल	agal
अगला	agala
अगली	agalee
अगले	agale
अगवा	agava
अगवाई	agavaee
अगवान	agavaan
अगवानपुर	agavaanapur
अगवानी	agavaanee
अगस्टे	agaste
अगस्त	agast
अगस्त्य	agasty
अगस्त्यमुनि	agastyamuni
अगहन	agahan
अगहनी	agahanee
अगा	aga
अगाध	agaadh
अगार	agaar
अगासी	agaasee
अगियाना	agiyaana
अगुआ	agua
अगुआई	aguaee
अगुण	agun
अगुवा	aguva
अगुवाई	aguvaee
अगेंस्ट	agenst
अगेन	agen
अगोचर	agochar
अगोरा	agora
अग्नायी	agnaayee
अग्नाशय	agnaashay
अग्नाशयकोप	agnaashayakop
अग्नाशयशोथ	agnaashayashoth
अग्नि	agni
अग्निकांड	agnikaand
अग्निकाण्ड	agnikaand
अग्निकुण्ड	agnikund
अग्निदाह	agnidaah
अग्निदेव	agnidev
अग्निदेवता	agnidevata
अग्निपथ	agnipath
अग्निपरीक्षा	agnipareeksha
अग्निपुराण	agnipuraan
अग्निपूजा	agnipooja
अग्निबाण	agnibaan
अग्निमित्र	agnimitr
अग्निरोधक	agnirodhak
अग्निवर्ण	agnivarn
अग्निवेश	agnivesh
अग्निशमन	agnishaman
अग्निसह	agnisah
अग्निसाक्षी	agnisaakshee
अग्निस्थान	agnisthaan
अग्निहोत्र	agnihotr
अग्निहोत्री	agnihotree
अग्न्यस्त्र	agnyastr
अग्न्याधान	agnyaadhaan
अग्न्याशय	agnyaashay
अग्र	agr
अग्रगण्य	agragany
अग्रगामी	agragaamee
अग्रग्रामी	agragraamee
अग्रचिंता	agrachinta
अग्रज	agraj
अग्रजा	agraja
अग्रणी	agranee
अग्रदल	agradal
अग्रदाय	agradaay
अग्रदूत	agradoot
अग्रदूती	agradootee
अग्रदूतीय	agradooteey
अग्रदूतों	agradooton
अग्रपाद	agrapaad
अग्रपीयूषिकाग्रंथि	agrapeeyooshikaagranthi
अग्रभाग	agrabhaag
अग्रभूमि	agrabhoomi
अग्रवानी	agravaanee
अग्रवाल	agravaal
अग्रवाही	agravaahee
अग्रसर	agrasar
अग्रसरना	agrasarana
अग्रसारित	agrasaarit
अग्रसेन	agrasen
अग्रहरि	agrahari
अग्रहार	agrahaar
अग्रांग	agraang
अग्रानुक्रम	agraanukram
अग्रि	agri
अग्रिम	agrim
अग्रिमराशि	agrimaraashi
अग्रिमों	agrimon
अग्रे	agre
अग्रेजी	agrejee
अग्रेषण	agreshan
अग्रेषित	agreshit
अघन	aghan
अघरिया	aghariya
अघात	aghaat
अघाना	aghaana
अघावना	aghaavana
अघिक	aghik
अघिकारी	aghikaaree
अघुलनशील	aghulanasheel
अघोर	aghor
अघोरी	aghoree
अघोषित	aghoshit
अचंभा	achambha
अचंभित	achambhit
अचंभे	achambhe
अचकन	achakan
अचक्रीय	achakreey
अचतुर	achatur
अचम्भा	achambha
अचम्भित	achambhit
अचम्भे	achambhe
अचयनित	achayanit
अचर	achar
अचरज	acharaj
अचरितार्थ	acharitaarth
अचल	achal
अचलता	achalata
अचला	achala
अचलेश्वर	achaleshvar
अचानक	achaanak
अचार	achaar
अचिंतित	achintit
अचिकित्स्य	achikitsy
अचित्रणीय	achitraneey
अचित्रित	achitrit
अचिह्नित	achihnit
अचीवमेंट	acheevament
अचूक	achook
अचेत	achet
अचेतन	achetan
अचेतना	achetana
अचेतावस्था	achetaavastha
अच्	ach
अच्छ	achchh
अच्छत	achchhat
अच्छा	achchha
अच्छाइयों	achchhaiyon
अच्छाई	achchhaee
अच्छापन	achchhaapan
अच्छी	achchhee
अच्छेपन	achchhepan
अच्युत	achyut
अछिद्र	achhidr
अछिद्रित	achhidrit
अछूत	achhoot
अछूता	achhoota
अछूती	achhootee
अछूते	achhoote
अछूतों	achhooton
अछेदित	achhedit
अछेद्य	achhedy
अज	aj
अजंता	ajanta
अजगर	ajagar
अजटिल	ajatil
अजनबियों	ajanabiyon
अजनबी	ajanabee
अजनबीपन	ajanabeepan
अजन्ता	ajanta
अजन्म	ajanm
अजन्मा	ajanma
अजन्मे	ajanme
अजमल	ajamal
अजमाद	ajamaad
अजमेर	ajamer
अजमेरी	ajameree
अजमोद	ajamod
अजय	ajay
अजयगढ़	ajayagadh
अजयपाल	ajayapaal
अजर	ajar
अजरबैजान	ajarabaijaan
अजवाइन	ajavain
अजवायन	ajavaayan
अजस्र	ajasr
अजहरुद्दीन	ajaharuddeen
अजा	aja
अजाक्स	ajaaks
अजात	ajaat
अजातशत्रु	ajaatashatru
अजाति	ajaati
अजान	ajaan
अजानपन	ajaanapan
अजाने	ajaane
अजामिल	ajaamil
अजायबघर	ajaayabaghar
अजित	ajit
अजिताभ	ajitaabh
अजिन	ajin
अजी	ajee
अजीज	ajeej
अजीजपुर	ajeejapur
अजीत	ajeet
अजीतगढ़	ajeetagadh
अजीब	ajeeb
अजीबपन	ajeebapan
अजीबो	ajeebo
अजीबोगरीब	ajeebogareeb
अजीबोग़रीब	ajeebogareeb
अजीम	ajeem
अजीमाबाद	ajeemaabaad
अजीरा	ajeera
अजीर्ण	ajeern
अजीर्णता	ajeernata
अजीव	ajeev
अजूबा	ajooba
अजूबे	ajoobe
अजूरा	ajoora
अजेय	ajey
अजेयता	ajeyata
अजैव	ajaiv
अजैविक	ajaivik
अज्ञ	agy
अज्ञात	agyaat
अज्ञातजनभीति	agyaatajanabheeti
अज्ञातवास	agyaatavaas
अज्ञातव्यक्तिभीत	agyaatavyaktibheet
अज्ञातहेतुक	agyaatahetuk
अज्ञान	agyaan
अज्ञानकृत	agyaanakrt
अज्ञानता	agyaanata
अज्ञानतापूर्वक	agyaanataapoorvak
अज्ञानतावश	agyaanataavash
अज्ञानपन	agyaanapan
अज्ञानि	agyaani
अज्ञानी	agyaanee
अज्ञेय	agyey
अज्ञेयता	agyeyata
अज्ञेयवाद	agyeyavaad
अज्ञेयवादी	agyeyavaadee
अज्नानता	ajnaanata
अट	at
अटंबर	atambar
अटकना	atakana
अटकल	atakal
अटकलबाजी	atakalabaajee
अटकलबाज़	atakalabaaz
अटकलबाज़ी	atakalabaazee
अटकलें	atakalen
अटकलों	atakalon
अटका	ataka
अटकाना	atakaana
अटके	atake
अटन	atan
अटना	atana
अटपटा	atapata
अटपटी	atapatee
अटरिया	atariya
अटर्नी	atarnee
अटल	atal
अटलजी	atalajee
अटलबिहारी	atalabihaaree
अटलांटा	atalaanta
अटलांटिक	atalaantik
अटलांटिकमहासागर	atalaantikamahaasaagar
अटलांटिस	atalaantis
अटवी	atavee
अटाटूट	ataatoot
अटापट्टू	ataapattoo
अटारी	ataaree
अटार्नी	ataarnee
अटाला	ataala
अटूट	atoot
अटेंडेंट	atendent
अटैक	ataik
अटैची	ataichee
अटॉर्नी	atornee
अट्टहास	attahaas
अट्टालिका	attaalika
अट्टी	attee
अट्ठकथा	atthakatha
अट्ठाईस	atthaees
अट्ठारह	atthaarah
अट्ठारहवीं	atthaarahaveen
अठखेलियां	athakheliyaan
अठन्नी	athannee
अठरीय	athareey
अठवाँसा	athavaansa
अठारह	athaarah
अठारहवां	athaarahavaan
अठारहवीं	athaarahaveen
अठारहवें	athaarahaven
अठास्सी	athaassee
अठौड़ी	athaudee
अडंगा	adanga
अडक	adak
अडाना	adaana
अडिग	adig
अडियल	adiyal
अडीग	adeeg
अडूसा	adoosa
अडैप्टर	adaiptar
अडोबी	adobee
अडोल	adol
अड्डा	adda
अड्डे	adde
अड्डों	addon
अड्रेस	adres
अणिमा	anima
अणु	anu
अणुओं	anuon
अणुभार	anubhaar
अणुव्रत	anuvrat
अणुसूत्र	anusootr
अण्टकोनीय	antakoneey
अण्टीगुआ	anteegua
अण्ड	and
अण्डज	andaj
अण्डपीत	andapeet
अण्डमान	andamaan
अण्डवक्र	andavakr
अण्डा	anda
अण्डाकार	andaakaar
अण्डाशय	andaashay
अण्डे	ande
अण्डों	andon
अण्डोत्सर्ग	andotsarg
अण्णा	anna
अत	at
अतंरराष्ट्रीय	atanraraashtreey
अतंर्राष्ट्रीय	atanrraashtreey
अतः	atah
अतएव	atev
अतत्पर	atatpar
अतनु	atanu
अतर	atar
अतरिक्त	atarikt
अतरौरा	ataraura
अतरौली	ataraulee
अतर्कसंगत	atarkasangat
अतल	atal
अतलस	atalas
अतलांतिक	atalaantik
अता	ata
अताईपुर	ataeepur
अतातुर्क	ataaturk
अतारांकित	ataaraankit
अतार्किक	ataarkik
अति	ati
अतिआवश्यक	atiaavashyak
अतिकाल	atikaal
अतिक्रम	atikram
अतिक्रमण	atikraman
अतिक्रमणकारी	atikramanakaaree
अतिक्रमी	atikramee
अतिक्रांत	atikraant
अतिक्रामक	atikraamak
अतिक्रामी	atikraamee
अतिघृणा	atighrna
अतिचतुर	atichatur
अतिचार	atichaar
अतिचारी	atichaaree
अतिचालक	atichaalak
अतिचालकता	atichaalakata
अतिथि	atithi
अतिथिगृह	atithigrh
अतिथियों	atithiyon
अतिथिशाला	atithishaala
अतिदुष्ट	atidusht
अतिदेय	atidey
अतिदेय	atidey
अतिधार्मिक	atidhaarmik
अतिधार्मिकता	atidhaarmikata
अतिनूतन	atinootan
अतिनैष्ठिक	atinaishthik
अतिनैष्ठिकता	atinaishthikata
अतिपरवलीय	atiparavaleey
अतिपराध्वनिक	atiparaadhvanik
अतिपरासारी	atiparaasaaree
अतिप्रजन	atiprajan
अतिप्रतापी	atiprataapee
अतिप्रवाह	atipravaah
अतिप्रवीण	atipraveen
अतिप्रशंसा	atiprashansa
अतिप्रसन्न	atiprasann
अतिप्राकलन	atipraakalan
अतिप्राकृत	atipraakrt
अतिप्राकृतिक	atipraakrtik
अतिप्राकृतिकता	atipraakrtikata
अतिप्रिय	atipriy
अतिबल	atibal
अतिबुकिंग	atibuking
अतिभार	atibhaar
अतिमानव	atimaanav
अतिमानवीय	atimaanaveey
अतियथार्थवाद	atiyathaarthavaad
अतियथार्थवादी	atiyathaarthavaadee
अतिरंजन	atiranjan
अतिरंजना	atiranjana
अतिरंजनापूर्ण	atiranjanaapoorn
अतिरंजित	atiranjit
अतिरंज्नापूर्ण	atiranjnaapoorn
अतिरिक्त	atirikt
अतिरिक्तता	atiriktata
अतिरूढ़िवादी	atiroodhivaadee
अतिरेक	atirek
अतिरेकना	atirekana
अतिलंघन	atilanghan
अतिलोभी	atilobhee
अतिलोलुप	atilolup
अतिवातायनता	ativaataayanata
अतिवाद	ativaad
अतिवादी	ativaadee
अतिविशाल	ativishaal
अतिविश्वास	ativishvaas
अतिविश्वासी	ativishvaasee
अतिवृद्धि	ativrddhi
अतिवृष्टि	ativrshti
अतिव्यय	ativyay
अतिव्ययी	ativyayee
अतिव्याकुलता	ativyaakulata
अतिव्याप्त	ativyaapt
अतिव्याप्ति	ativyaapti
अतिशय	atishay
अतिशयोक्ति	atishayokti
अतिशयोक्तिपूर्ण	atishayoktipoorn
अतिशयोक्त्तिपूर्ण	atishayokttipoorn
अतिशीघ्र	atisheeghr
अतिशेष	atishesh
अतिशोषण	atishoshan
अतिश्योक्ति	atishyokti
अतिसंवाहक	atisanvaahak
अतिसंवाहकता	atisanvaahakata
अतिसंवेदनशीलता	atisanvedanasheelata
अतिसंवेदी	atisanvedee
अतिसार	atisaar
अतिसारीय	atisaareey
अतीत	ateet
अतीन्द्रिय	ateendriy
अतीव	ateev
अतीस	atees
अतुल	atul
अतुलनीय	atulaneey
अतुल्य	atuly
अतृप्त	atrpt
अतृप्तता	atrptata
अतृप्ति	atrpti
अतृप्य	atrpy
अतेव	atev
अतोषणीय	atoshaneey
अतोष्य	atoshy
अत्तारी	attaaree
अत्यंत	atyant
अत्यंतता	atyantata
अत्यधिक	atyadhik
अत्यधिकता	atyadhikata
अत्यन्त	atyant
अत्यल्प	atyalp
अत्याचर	atyaachar
अत्याचार	atyaachaar
अत्याचारपूर्ण	atyaachaarapoorn
अत्याचारी	atyaachaaree
अत्याचारों	atyaachaaron
अत्याधिक	atyaadhik
अत्याधुनिक	atyaadhunik
अत्यावश्यक	atyaavashyak
अत्यावश्यकता	atyaavashyakata
अत्युत्तमता	atyuttamata
अत्युत्सुक	atyutsuk
अत्युष्ण	atyushn
अत्र	atr
अत्री	atree
अत्रे	atre
अथक	athak
अथमलगोला	athamalagola
अथर्व	atharv
अथर्ववेद	atharvaved
अथर्ववेदीय	atharvavedeey
अथवा	athava
अथाई	athaee
अथाना	athaana
अथाह	athaah
अथीना	atheena
अथॉरिटी	athoritee
अदंड	adand
अदक्षता	adakshata
अदत्त	adatt
अदत्तवेतन	adattavetan
अदद	adad
अदन	adan
अदना	adana
अदनान	adanaan
अदब	adab
अदभुत	adabhut
अदभूत	adabhoot
अदम	adam
अदमनीय	adamaneey
अदमित	adamit
अदम्य	adamy
अदर	adar
अदरक	adarak
अदरख	adarakh
अदर्शन	adarshan
अदल	adal
अदला	adala
अदलीय	adaleey
अदह	adah
अदहन	adahan
अदा	ada
अदाएं	adaen
अदाओं	adaon
अदाकर्ता	adaakarta
अदाकार	adaakaar
अदाकारा	adaakaara
अदाकारी	adaakaaree
अदायगी	adaayagee
अदालत	adaalat
अदालती	adaalatee
अदालतें	adaalaten
अदालतों	adaalaton
अदावत	adaavat
अदावती	adaavatee
अदाह्य	adaahy
अदि	adi
अदित	adit
अदिति	aditi
अदिनांकित	adinaankit
अदिलाबादु	adilaabaadu
अदिश	adish
अदिष्ट	adisht
अदीब	adeeb
अदीस	adees
अदूरदर्शा	adooradarsha
अदूरदर्शिता	adooradarshita
अदूरदर्शी	adooradarshee
अदूषित	adooshit
अदूष्य	adooshy
अदृश्य	adrshy
अदृष्ट	adrsht
अदृढ़	adrdh
अदृढ़ता	adrdhata
अदेखा	adekha
अदेयता	adeyata
अद्	ad
अद्दूपुर	addoopur
अद्भुत	adbhut
अद्भुताकार	adbhutaakaar
अद्भूत	adbhoot
अद्यतन	adyatan
अद्यतनीकरण	adyataneekaran
अद्यतित	adyatit
अद्रि	adri
अद्रोह	adroh
अद्वितीय	adviteey
अद्वितीयता	adviteeyata
अद्वेष	advesh
अद्वेष्टा	adveshta
अद्वैत	advait
अद्वैतवाद	advaitavaad
अद्वैतवादी	advaitavaadee
अध	adh
अधःशैल	adhahshail
अधकचरा	adhakachara
अधखुला	adhakhula
अधगति	adhagati
अधचरा	adhachara
अधन्ना	adhanna
अधन्यवादी	adhanyavaadee
अधपका	adhapaka
अधपके	adhapake
अधपन्ना	adhapanna
अधम	adham
अधमता	adhamata
अधमरा	adhamara
अधमर्ण	adhamarn
अधमाधम	adhamaadham
अधमी	adhamee
अधमुआ	adhamua
अधर	adhar
अधरांग	adharaang
अधरामृत	adharaamrt
अधरासव	adharaasav
अधरों	adharon
अधर्म	adharm
अधर्मता	adharmata
अधर्मशीलता	adharmasheelata
अधर्मिता	adharmita
अधर्मी	adharmee
अधर्मीपन	adharmeepan
अधातु	adhaatu
अधातुओं	adhaatuon
अधाम	adhaam
अधार	adhaar
अधार्मिक	adhaarmik
अधार्मिकता	adhaarmikata
अधि	adhi
अधिक	adhik
अधिकतम	adhikatam
अधिकतर	adhikatar
अधिकता	adhikata
अधिकर	adhikar
अधिकरण	adhikaran
अधिकरणों	adhikaranon
अधिकरी	adhikaree
अधिकर्मी	adhikarmee
अधिकश्रम	adhikashram
अधिकाँश	adhikaansh
अधिकांश	adhikaansh
अधिकांशत	adhikaanshat
अधिकांशतः	adhikaanshatah
अधिकांशतया	adhikaanshataya
अधिकाधिक	adhikaadhik
अधिकार	adhikaar
अधिकारक्षेत्र	adhikaarakshetr
अधिकारतः	adhikaaratah
अधिकारपत्र	adhikaarapatr
अधिकारपूर्ण	adhikaarapoorn
अधिकारपूर्वक	adhikaarapoorvak
अधिकारयों	adhikaarayon
अधिकारहीन	adhikaaraheen
अधिकारातीत	adhikaaraateet
अधिकारिक	adhikaarik
अधिकारिणी	adhikaarinee
अधिकारिता	adhikaarita
अधिकारियों	adhikaariyon
अधिकारी	adhikaaree
अधिकारीई	adhikaareeee
अधिकारीकरण	adhikaareekaran
अधिकारीगण	adhikaareegan
अधिकारीयों	adhikaareeyon
अधिकारो	adhikaaro
अधिकारों	adhikaaron
अधिकृत	adhikrt
अधिकृति	adhikrti
अधिकेंद्र	adhikendr
अधिकोष	adhikosh
अधिक्षक	adhikshak
अधिक्षेप	adhikshep
अधिगण	adhigan
अधिगम	adhigam
अधिगृहित	adhigrhit
अधिगृहीत	adhigrheet
अधिग्रहण	adhigrahan
अधिग्रहणों	adhigrahanon
अधिग्रहित	adhigrahit
अधिग्रहीत	adhigraheet
अधिग्राहक	adhigraahak
अधिचक्रज	adhichakraj
अधिचर्म	adhicharm
अधिचित्र	adhichitr
अधित्यका	adhityaka
अधित्याग	adhityaag
अधिदर्शक	adhidarshak
अधिदेव	adhidev
अधिदेश	adhidesh
अधिदेशात्मक	adhideshaatmak
अधिनस्थ	adhinasth
अधिनायक	adhinaayak
अधिनायकवादी	adhinaayakavaadee
अधिनियम	adhiniyam
अधिनियमन	adhiniyaman
अधिनियमित	adhiniyamit
अधिनियमों	adhiniyamon
अधिनिर्णय	adhinirnay
अधिनिर्णायक	adhinirnaayak
अधिनोवा	adhinova
अधिपति	adhipati
अधिपत्य	adhipaty
अधिपत्र	adhipatr
अधिप्रचार	adhiprachaar
अधिप्रचारक	adhiprachaarak
अधिप्राप्ति	adhipraapti
अधिप्रेक्षक	adhiprekshak
अधिभार	adhibhaar
अधिभावी	adhibhaavee
अधिभास्वीय	adhibhaasveey
अधिभोगी	adhibhogee
अधिमत	adhimat
अधिमांस	adhimaans
अधिमान	adhimaan
अधिमानतः	adhimaanatah
अधिमानी	adhimaanee
अधिमान्य	adhimaany
अधिमास	adhimaas
अधियज्ञ	adhiyagy
अधिया	adhiya
अधियाचक	adhiyaachak
अधियाना	adhiyaana
अधिरचना	adhirachana
अधिरोध	adhirodh
अधिरोपण	adhiropan
अधिरोपित	adhiropit
अधिरोहण	adhirohan
अधिलाभांश	adhilaabhaansh
अधिवक्ता	adhivakta
अधिवक्ताओं	adhivaktaon
अधिवक्तृता	adhivaktrta
अधिवचन	adhivachan
अधिवर्ष	adhivarsh
अधिवर्षिता	adhivarshita
अधिवास	adhivaas
अधिवासित	adhivaasit
अधिवासियों	adhivaasiyon
अधिवासी	adhivaasee
अधिविकर्षण	adhivikarshan
अधिवृक्क	adhivrkk
अधिवृक्की	adhivrkkee
अधिवेशन	adhiveshan
अधिवेशनों	adhiveshanon
अधिव्यय	adhivyay
अधिशासी	adhishaasee
अधिशेष	adhishesh
अधिशोष्य	adhishoshy
अधिष्टाता	adhishtaata
अधिष्ठाता	adhishthaata
अधिष्ठात्री	adhishthaatree
अधिष्ठान	adhishthaan
अधिष्ठापन	adhishthaapan
अधिष्ठित	adhishthit
अधिसंख्य	adhisankhy
अधिसंपत्ति	adhisampatti
अधिसमय	adhisamay
अधिसूचना	adhisoochana
अधिसूचित	adhisoochit
अधिस्थगन	adhisthagan
अधीक्षक	adheekshak
अधीक्षकों	adheekshakon
अधीक्षण	adheekshan
अधीक्षिका	adheekshika
अधीन	adheen
अधीनता	adheenata
अधीनस्थ	adheenasth
अधीनस्थों	adheenasthon
अधीनीकरण	adheeneekaran
अधीर	adheer
अधीरता	adheerata
अधुना	adhuna
अधुनातन	adhunaatan
अधूरा	adhoora
अधूरापन	adhooraapan
अधूरी	adhooree
अधूरे	adhoore
अधेड़	adhed
अधोगामी	adhogaamee
अधोजलीय	adhojaleey
अधोबिंदु	adhobindu
अधोमुखी	adhomukhee
अधोरक्त	adhorakt
अधोलंब	adholamb
अधोलोक	adholok
अधोलौकिक	adholaukik
अधोवर्ती	adhovartee
अधोवर्धी	adhovardhee
अधोवस्त्र	adhovastr
अधोवेष्टन	adhoveshtan
अधोसंरचना	adhosanrachana
अध्यक्ष	adhyaksh
अध्यक्षता	adhyakshata
अध्यक्षा	adhyaksha
अध्यक्षीय	adhyaksheey
अध्यक्षों	adhyakshon
अध्यन	adhyan
अध्ययन	adhyayan
अध्ययनीय	adhyayaneey
अध्ययनों	adhyayanon
अध्यर्थन	adhyarthan
अध्यर्थित	adhyarthit
अध्यवसाय	adhyavasaay
अध्यवसायी	adhyavasaayee
अध्यशन	adhyashan
अध्यात्म	adhyaatm
अध्यात्मवाद	adhyaatmavaad
अध्यात्मवादी	adhyaatmavaadee
अध्यात्मिक	adhyaatmik
अध्यादेश	adhyaadesh
अध्यापक	adhyaapak
अध्यापकी	adhyaapakee
अध्यापकों	adhyaapakon
अध्यापन	adhyaapan
अध्यापिका	adhyaapika
अध्याय	adhyaay
अध्यायों	adhyaayon
अध्यारोप	adhyaarop
अध्यारोपित	adhyaaropit
अध्येता	adhyeta
अध्येताओं	adhyetaon
अध्येतावृत्ति	adhyetaavrtti
अध्वनितता	adhvanitata
अनंग	anang
अनंगपाल	anangapaal
अनंगीकरण	anangeekaran
अनंगुलिता	anangulita
अनंत	anant
अनंतकालीन	anantakaaleen
अनंतनाग	anantanaag
अनंतपुर	anantapur
अनंतर	anantar
अनंता	ananta
अनंतिम	anantim
अनंशदायीतर	ananshadaayeetar
अनअभीजात	anabheejaat
अनकटा	anakata
अनकहा	anakaha
अनकही	anakahee
अनके	anake
अनगढ	anagadh
अनगणित	anaganit
अनगिन	anagin
अनगिनत	anaginat
अनगढ़पन	anagadhapan
अनगढ़ा	anagadha
अनघ	anagh
अनचाहा	anachaaha
अनचाही	anachaahee
अनचाहे	anachaahe
अनचेता	anacheta
अनछुआ	anachhua
अनछुए	anachhue
अनजान	anajaan
अनजानपन	anajaanapan
अनजाना	anajaana
अनजानी	anajaanee
अनजाने	anajaane
अनजुता	anajuta
अनट	anat
अनटूटा	anatoota
अनत	anat
अनतराशा	anataraasha
अनतोड़ा	anatoda
अनदेखा	anadekha
अनदेखी	anadekhee
अनधिक	anadhik
अनधिकार	anadhikaar
अनधिकारिक	anadhikaarik
अनधिकारी	anadhikaaree
अनधिकृत	anadhikrt
अनधिमान	anadhimaan
अनधियाचित	anadhiyaachit
अनधीनता	anadheenata
अननुकरणीय	ananukaraneey
अननुकूल	ananukool
अननुकूलता	ananukoolata
अननुकूलित	ananukoolit
अननुभूत	ananubhoot
अननुमोदित	ananumodit
अनन्त	anant
अनन्तता	anantata
अनन्तर	anantar
अनन्तरकालीन	anantarakaaleen
अनन्नास	anannaas
अनन्य	anany
अनन्यता	ananyata
अनन्याधिकार	ananyaadhikaar
अनन्याश्रित	ananyaashrit
अनपढ	anapadh
अनपवर्तित	anapavartit
अनपेक्षित	anapekshit
अनपेक्षितता	anapekshitata
अनपेक्ष्य	anapekshy
अनपढ़	anapadh
अनबन	anaban
अनबाइंड	anabaind
अनबूझ	anaboojh
अनब्याहा	anabyaaha
अनब्रेकेबल	anabrekebal
अनभिज्ञ	anabhigy
अनभिज्ञता	anabhigyata
अनभिज्ञतापूर्वक	anabhigyataapoorvak
अनभिज्ञात	anabhigyaat
अनभीष्ट	anabheesht
अनम	anam
अनमना	anamana
अनमनापन	anamanaapan
अनमनीय	anamaneey
अनमित	anamit
अनमिल	anamil
अनमोल	anamol
अनम्य	anamy
अनयता	anayata
अनयन	anayan
अनरथ	anarath
अनरस	anaras
अनर्गल	anargal
अनर्थ	anarth
अनर्थक	anarthak
अनर्थकता	anarthakata
अनर्थकारी	anarthakaaree
अनर्ह	anarh
अनर्हकरण	anarhakaran
अनर्हीकरण	anarheekaran
अनल	anal
अनलँकृत	analankrt
अनलसित	analasit
अनलिखा	analikha
अनलिमिटेड	analimited
अनलेडेड	analeded
अनलॉक	analok
अनलोडिंग	analoding
अनवकाश	anavakaash
अनवगत	anavagat
अनवद्य	anavady
अनवधार्य	anavadhaary
अनवधि	anavadhi
अनवर	anavar
अनवरत	anavarat
अनवलंबित	anavalambit
अनवसर	anavasar
अनवहित	anavahit
अनवाँसा	anavaansa
अनवीकरणीय	anaveekaraneey
अनवेषण	anaveshan
अनशन	anashan
अनश्वर	anashvar
अनश्वरता	anashvarata
अनसुधरा	anasudhara
अनसुना	anasuna
अनसुनी	anasunee
अनसुलझा	anasulajha
अनसुलझी	anasulajhee
अनसुलझे	anasulajhe
अनस्थिरता	anasthirata
अनहद	anahad
अनहित	anahit
अनहोनी	anahonee
अनाकर्षक	anaakarshak
अनाकार	anaakaar
अनाक्रांत	anaakraant
अनाक्रांता	anaakraanta
अनाक्रामक	anaakraamak
अनागत	anaagat
अनाचार	anaachaar
अनाचारिता	anaachaarita
अनाच्छादन	anaachchhaadan
अनाज	anaaj
अनाजों	anaajon
अनातोलिया	anaatoliya
अनातोली	anaatolee
अनात्म	anaatm
अनात्मवाद	anaatmavaad
अनाथ	anaath
अनाथालय	anaathaalay
अनाथालयों	anaathaalayon
अनाथाश्रम	anaathaashram
अनाथों	anaathon
अनादर	anaadar
अनादरणीय	anaadaraneey
अनादरसूचक	anaadarasoochak
अनादि	anaadi
अनादिकाल	anaadikaal
अनादिष्ट	anaadisht
अनादृत	anaadrt
अनाधिकारिक	anaadhikaarik
अनाधिकृत	anaadhikrt
अनाधीन	anaadheen
अनाधीनता	anaadheenata
अनानास	anaanaas
अनापत्ति	anaapatti
अनापत्तिजनक	anaapattijanak
अनापशनाप	anaapashanaap
अनापहारी	anaapahaaree
अनापा	anaapa
अनाबंटित	anaabantit
अनाभूषित	anaabhooshit
अनाम	anaam
अनामय	anaamay
अनामांकित	anaamaankit
अनामिका	anaamika
अनामी	anaamee
अनायास	anaayaas
अनार	anaar
अनारकली	anaarakalee
अनारक्षित	anaarakshit
अनारोपणीय	anaaropaneey
अनारोहणीय	anaarohaneey
अनार्थिक	anaarthik
अनार्य	anaary
अनार्यक	anaaryak
अनालंकारिक	anaalankaarik
अनावरण	anaavaran
अनावश्यक	anaavashyak
अनावृत	anaavrt
अनावृतबीजी	anaavrtabeejee
अनावृत्ति	anaavrtti
अनावृष्टि	anaavrshti
अनावेशित	anaaveshit
अनाश्रित	anaashrit
अनास	anaas
अनासक्त	anaasakt
अनासक्ति	anaasakti
अनासक्त्त	anaasaktt
अनास्था	anaastha
अनाहत	anaahat
अनाड़ी	anaadee
अनाड़ीपन	anaadeepan
अनिकेत	aniket
अनिच्छा	anichchha
अनिच्छापूर्वक	anichchhaapoorvak
अनिच्छुक	anichchhuk
अनिता	anita
अनित्य	anity
अनित्यता	anityata
अनिदानिएअ	anidaanie
अनिदान्य	anidaany
अनिद्र	anidr
अनिद्ररोग	anidrarog
अनिद्रा	anidra
अनिद्रित	anidrit
अनिधिक	anidhik
अनिपुण	anipun
अनिमंत्रित	animantrit
अनिमित्त	animitt
अनिमेष	animesh
अनियंत्रणीय	aniyantraneey
अनियंत्रणीयता	aniyantraneeyata
अनियंत्रित	aniyantrit
अनियत	aniyat
अनियमित	aniyamit
अनियमितता	aniyamitata
अनियमितताएं	aniyamitataen
अनियमितताओं	aniyamitataon
अनियोजित	aniyojit
अनिरुद्ध	aniruddh
अनिरूद्ध	anirooddh
अनिर्णय	anirnay
अनिर्णायक	anirnaayak
अनिर्दिष्ट	anirdisht
अनिर्धारित	anirdhaarit
अनिर्धार्यता	anirdhaaryata
अनिर्वचनीय	anirvachaneey
अनिर्वाच्य	anirvaachy
अनिर्विघ्नता	anirvighnata
अनिल	anil
अनिवारित	anivaarit
अनिवार्य	anivaary
अनिवार्यत	anivaaryat
अनिवार्यतः	anivaaryatah
अनिवार्यता	anivaaryata
अनिवासी	anivaasee
अनिश्चतता	anishchatata
अनिश्चय	anishchay
अनिश्चय	anishchay
अनिश्चयात्मकता	anishchayaatmakata
अनिश्चयी	anishchayee
अनिश्चायक	anishchaayak
अनिश्चित	anishchit
अनिश्चितकालीन	anishchitakaaleen
अनिश्चितता	anishchitata
अनिश्चितताओं	anishchitataon
अनिश्चेय	anishchey
अनिष्ट	anisht
अनिष्टकर	anishtakar
अनिष्टकारक	anishtakaarak
अनिष्टकारी	anishtakaaree
अनिष्टसूचक	anishtasoochak
अनिष्टार्थी	anishtaarthee
अनीक	aneek
अनीता	aneeta
अनीति	aneeti
अनीदार	aneedaar
अनीश	aneesh
अनीश्वरवाद	aneeshvaravaad
अनीश्वरवादी	aneeshvaravaadee
अनीस	anees
अनीह	aneeh
अनु	anu
अनुकंपन	anukampan
अनुकंपा	anukampa
अनुकंपित	anukampit
अनुकंपीतंत्रिकानुकारी	anukampeetantrikaanukaaree
अनुकम्पा	anukampa
अनुकरण	anukaran
अनुकरणकर्ता	anukaranakarta
अनुकरणशील	anukaranasheel
अनुकरणीय	anukaraneey
अनुकर्ता	anukarta
अनुकर्षण	anukarshan
अनुकलन	anukalan
अनुकारक	anukaarak
अनुकारी	anukaaree
अनुकुल	anukul
अनुकूल	anukool
अनुकूलता	anukoolata
अनुकूलन	anukoolan
अनुकूलनशील	anukoolanasheel
अनुकूलनशीलता	anukoolanasheelata
अनुकूलनीय	anukoolaneey
अनुकूलनीयता	anukoolaneeyata
अनुकूलित	anukoolit
अनुकूली	anukoolee
अनुकृत	anukrt
अनुकृति	anukrti
अनुक्त	anukt
अनुक्रम	anukram
अनुक्रमण	anukraman
अनुक्रमणिका	anukramanika
अनुक्रमणीकार	anukramaneekaar
अनुक्रमांक	anukramaank
अनुक्रमिक	anukramik
अनुक्रमित	anukramit
अनुक्रिया	anukriya
अनुक्रोश	anukrosh
अनुक्षण	anukshan
अनुक्षेट्र	anukshetr
अनुगमन	anugaman
अनुगामिता	anugaamita
अनुगामी	anugaamee
अनुगुण	anugun
अनुगुल	anugul
अनुगूँज	anugoonj
अनुगूंज	anugoonj
अनुग्रह	anugrah
अनुग्रहकारी	anugrahakaaree
अनुग्रहपूर्वक	anugrahapoorvak
अनुग्रहशील	anugrahasheel
अनुग्रहि	anugrahi
अनुग्राहक	anugraahak
अनुग्राही	anugraahee
अनुग्राह्यतापूर्वक	anugraahyataapoorvak
अनुचर	anuchar
अनुचरों	anucharon
अनुचार	anuchaar
अनुचारक	anuchaarak
अनुचित	anuchit
अनुचितता	anuchitata
अनुचित्र	anuchitr
अनुच्छेद	anuchchhed
अनुच्छेदक	anuchchhedak
अनुच्छेदों	anuchchhedon
अनुज	anuj
अनुजा	anuja
अनुज्ञप्त	anugyapt
अनुज्ञप्ति	anugyapti
अनुज्ञप्तिधारी	anugyaptidhaaree
अनुज्ञा	anugya
अनुज्ञात	anugyaat
अनुज्ञात्मक	anugyaatmak
अनुज्ञापत्र	anugyaapatr
अनुज्ञापन	anugyaapan
अनुज्ञापित	anugyaapit
अनुज्ञाप्रद	anugyaaprad
अनुज्ञाप्राप्त	anugyaapraapt
अनुज्ञेय	anugyey
अनुतोष	anutosh
अनुत्तर	anuttar
अनुत्तरदायी	anuttaradaayee
अनुत्तरित	anuttarit
अनुत्तीर्ण	anutteern
अनुत्तेजक	anuttejak
अनुत्तेजनशील	anuttejanasheel
अनुत्पादकता	anutpaadakata
अनुत्प्रेरित	anutprerit
अनुदत्त	anudatt
अनुदर्शन	anudarshan
अनुदात्त	anudaatt
अनुदान	anudaan
अनुदानों	anudaanon
अनुदार	anudaar
अनुदारता	anudaarata
अनुदारपंथी	anudaarapanthee
अनुदारवाद	anudaaravaad
अनुदारवादी	anudaaravaadee
अनुदित	anudit
अनुदेश	anudesh
अनुदेशक	anudeshak
अनुदेशन	anudeshan
अनुदेशात्मक	anudeshaatmak
अनुदैर्घ्य	anudairghy
अनुदैर्ध्य	anudairdhy
अनुद्योग	anudyog
अनुद्योगी	anudyogee
अनुधावन	anudhaavan
अनुधुगीकरण	anudhugeekaran
अनुनय	anunay
अनुनयी	anunayee
अनुनाद	anunaad
अनुनादक	anunaadak
अनुनादी	anunaadee
अनुपचारित	anupachaarit
अनुपत	anupat
अनुपद	anupad
अनुपन	anupan
अनुपम	anupam
अनुपमता	anupamata
अनुपमा	anupama
अनुपयुक्त	anupayukt
अनुपयुक्तता	anupayuktata
अनुपयुक्त्त	anupayuktt
अनुपयोग	anupayog
अनुपयोगिता	anupayogita
अनुपयोगी	anupayogee
अनुपर्णी	anuparnee
अनुपलब्ध	anupalabdh
अनुपलब्धता	anupalabdhata
अनुपलभ्य	anupalabhy
अनुपस्थायी	anupasthaayee
अनुपस्थित	anupasthit
अनुपस्थिति	anupasthiti
अनुपात	anupaat
अनुपातहीन	anupaataheen
अनुपातहीनता	anupaataheenata
अनुपातिक	anupaatik
अनुपातित	anupaatit
अनुपाती	anupaatee
अनुपातों	anupaaton
अनुपालक	anupaalak
अनुपालन	anupaalan
अनुपूरक	anupoorak
अनुपूरण	anupooran
अनुपूर्ति	anupoorti
अनुप्रमाणन	anupramaanan
अनुप्रमाणित	anupramaanit
अनुप्रमाणित	anupramaanit
अनुप्रयुक्त	anuprayukt
अनुप्रयोग	anuprayog
अनुप्रयोगी	anuprayogee
अनुप्रयोगों	anuprayogon
अनुप्रवाह	anupravaah
अनुप्रस्थ	anuprasth
अनुप्राणन	anupraanan
अनुप्राणित	anupraanit
अनुप्रास	anupraas
अनुप्रेषण	anupreshan
अनुप्रेषित	anupreshit
अनुबंध	anubandh
अनुबंधक	anubandhak
अनुबंधित	anubandhit
अनुबंधों	anubandhon
अनुबन्ध	anubandh
अनुबोध	anubodh
अनुभव	anubhav
अनुभवजन्य	anubhavajany
अनुभवहीन	anubhavaheen
अनुभवहीनता	anubhavaheenata
अनुभवात्मक	anubhavaatmak
अनुभवी	anubhavee
अनुभवों	anubhavon
अनुभाग	anubhaag
अनुभागीय	anubhaageey
अनुभागों	anubhaagon
अनुभूत	anubhoot
अनुभूति	anubhooti
अनुभूतिक्षमता	anubhootikshamata
अनुभूतियाँ	anubhootiyaan
अनुभूतियों	anubhootiyon
अनुमंडल	anumandal
अनुमण्डल	anumandal
अनुमत	anumat
अनुमति	anumati
अनुमतियाँ	anumatiyaan
अनुममर्थन	anumamarthan
अनुमस्तिष्क	anumastishk
अनुमान	anumaan
अनुमानत	anumaanat
अनुमानत	anumaanat
अनुमानतः	anumaanatah
अनुमानित	anumaanit
अनुमानी	anumaanee
अनुमानों	anumaanon
अनुमार्गण	anumaargan
अनुमित	anumit
अनुमिति	anumiti
अनुमेय	anumey
अनुमोदक	anumodak
अनुमोदन	anumodan
अनुमोदनकर्ता	anumodanakarta
अनुमोदनार्थ	anumodanaarth
अनुमोदनीय	anumodaneey
अनुमोदित	anumodit
अनुयाइयों	anuyaiyon
अनुयान	anuyaan
अनुयायियों	anuyaayiyon
अनुयायी	anuyaayee
अनुयायीवर्ग	anuyaayeevarg
अनुयोक्ता	anuyokta
अनुयोगी	anuyogee
अनुयोजकता	anuyojakata
अनुयोजन	anuyojan
अनुयोजित	anuyojit
अनुरंजक	anuranjak
अनुरंजन	anuranjan
अनुरंजित	anuranjit
अनुरक्त	anurakt
अनुरक्ति	anurakti
अनुरक्षक	anurakshak
अनुरक्षण	anurakshan
अनुरक्षित	anurakshit
अनुराग	anuraag
अनुरागहीन	anuraagaheen
अनुरागी	anuraagee
अनुराधा	anuraadha
अनुरुप	anurup
अनुरूप	anuroop
अनुरूपण	anuroopan
अनुरूपता	anuroopata
अनुरेख	anurekh
अनुरेखक	anurekhak
अनुरेखण	anurekhan
अनुरेखन	anurekhan
अनुरोध	anurodh
अनुरोधों	anurodhon
अनुर्वरता	anurvarata
अनुलंब	anulamb
अनुलग्नक	anulagnak
अनुलग्नन	anulagnan
अनुलब्धियां	anulabdhiyaan
अनुलवन	anulavan
अनुलिपि	anulipi
अनुलिपिकरण	anulipikaran
अनुलेख	anulekh
अनुलोम	anulom
अनुवर्तन	anuvartan
अनुवर्ती	anuvartee
अनुवर्त्ती	anuvarttee
अनुवांशिक	anuvaanshik
अनुवांशिकता	anuvaanshikata
अनुवांशिकी	anuvaanshikee
अनुवाद	anuvaad
अनुवादक	anuvaadak
अनुवादकों	anuvaadakon
अनुवादनीय	anuvaadaneey
अनुवादित	anuvaadit
अनुवादी	anuvaadee
अनुवादों	anuvaadon
अनुवाद्य	anuvaady
अनुवित्त	anuvitt
अनुविभाग	anuvibhaag
अनुविभागीय	anuvibhaageey
अनुशंसा	anushansa
अनुशंसित	anushansit
अनुशासक	anushaasak
अनुशासन	anushaasan
अनुशासनपूर्वक	anushaasanapoorvak
अनुशासनप्रिय	anushaasanapriy
अनुशासनबद्ध	anushaasanabaddh
अनुशासनहीन	anushaasanaheen
अनुशासनहीनता	anushaasanaheenata
अनुशासनात्मक	anushaasanaatmak
अनुशासनिक	anushaasanik
अनुशासनों	anushaasanon
अनुशासित	anushaasit
अनुशास्ति	anushaasti
अनुशिष्ट	anushisht
अनुशीर्षक	anusheershak
अनुशीलता	anusheelata
अनुशीलन	anusheelan
अनुशीलित	anusheelit
अनुशोधन	anushodhan
अनुश्रवण	anushravan
अनुश्रुत	anushrut
अनुश्रुति	anushruti
अनुश्रुतियों	anushrutiyon
अनुश्रुतियों	anushrutiyon
अनुश्रोता	anushrota
अनुषंगियों	anushangiyon
अनुषंगी	anushangee
अनुषा	anusha
अनुष्का	anushka
अनुष्टुप	anushtup
अनुष्ठाता	anushthaata
अनुष्ठान	anushthaan
अनुष्ठानकर्ता	anushthaanakarta
अनुष्ठानों	anushthaanon
अनुसंधान	anusandhaan
अनुसंधानकर्ता	anusandhaanakarta
अनुसंधानकर्ताओं	anusandhaanakartaon
अनुसंधानशाला	anusandhaanashaala
अनुसंधानी	anusandhaanee
अनुसंधानों	anusandhaanon
अनुसंधायक	anusandhaayak
अनुसंधित्सु	anusandhitsu
अनुसचिव	anusachiv
अनुसचिवीय	anusachiveey
अनुसमर्थन	anusamarthan
अनुसमर्थित	anusamarthit
अनुसरण	anusaran
अनुसरणकर्ता	anusaranakarta
अनुसरणीय	anusaraneey
अनुसार	anusaar
अनुसारक	anusaarak
अनुसारता	anusaarata
अनुसारी	anusaaree
अनुसुइया	anusuiya
अनुसूचित	anusoochit
अनुसूचियों	anusoochiyon
अनुसूची	anusoochee
अनुसेवा	anuseva
अनुसेवी	anusevee
अनुस्खीय	anuskheey
अनुस्मरण	anusmaran
अनुस्मारक	anusmaarak
अनुस्मृति	anusmrti
अनुस्यूत	anusyoot
अनुस्रोता	anusrota
अनुस्वाद	anusvaad
अनुस्वार	anusvaar
अनूठा	anootha
अनूठी	anoothee
अनूठे	anoothe
अनूदित	anoodit
अनूप	anoop
अनूपपुर	anoopapur
अनूपम	anoopam
अनूपशहर	anoopashahar
अनूढ़ागमन	anoodhaagaman
अने	ane
अनेक	anek
अनेकता	anekata
अनेकवादी	anekavaadee
अनेकानेक	anekaanek
अनेको	aneko
अनेकों	anekon
अनैकांतिक	anaikaantik
अनैच्छिक	anaichchhik
अनैतिक	anaitik
अनैतिकता	anaitikata
अनैतिकतापूर्ण	anaitikataapoorn
अनैतिकतापूर्वक	anaitikataapoorvak
अनैयायिक	anaiyaayik
अनोखा	anokha
अनोखी	anokhee
अनोखे	anokhe
अनौखा	anaukha
अनौचित्य	anauchity
अनौपचारिक	anaupachaarik
अनौपचारिकता	anaupachaarikata
अन्जान	anjaan
अन्डोरा	andora
अन्त	ant
अन्तःकरण	antahkaran
अन्तःकाष्ठ	antahkaashth
अन्तःकेन्द्र	antahkendr
अन्तःकेन्द्रिक	antahkendrik
अन्तःक्षेपण	antahkshepan
अन्तःवासी	antahvaasee
अन्तःसंगीत	antahsangeet
अन्तकाल	antakaal
अन्तगर्भाशायी	antagarbhaashaayee
अन्तत	antat
अन्ततः	antatah
अन्ततोगत्वा	antatogatva
अन्तर	antar
अन्तरंग	antarang
अन्तरजाल	antarajaal
अन्तरण	antaran
अन्तरराष्ट्रीय	antararaashtreey
अन्तरात्मा	antaraatma
अन्तराल	antaraal
अन्तराष्ट्रीय	antaraashtreey
अन्तरिक्ष	antariksh
अन्तर्गत	antargat
अन्तर्जंघिका	antarjanghika
अन्तर्जाल	antarjaal
अन्तर्ज्ञानवादी	antargyaanavaadee
अन्तर्दर्शन	antardarshan
अन्तर्दशा	antardasha
अन्तर्धर्मसंप्रदायी	antardharmasampradaayee
अन्तर्धान	antardhaan
अन्तर्निर्मित	antarnirmit
अन्तर्निहित	antarnihit
अन्तर्मन	antarman
अन्तर्यामी	antaryaamee
अन्तर्राज्यीय	antarraajyeey
अन्तर्राष्ट्रीय	antarraashtreey
अन्तर्रोधन	antarrodhan
अन्तर्वाह	antarvaah
अन्तर्संस्था	antarsanstha
अन्तहीन	antaheen
अन्तिम	antim
अन्त्येष्टि	antyeshti
अन्दर	andar
अन्दाज	andaaj
अन्दाजा	andaaja
अन्दाज़	andaaz
अन्ध	andh
अन्धकार	andhakaar
अन्धता	andhata
अन्धविश्वास	andhavishvaas
अन्धविश्वासी	andhavishvaasee
अन्धा	andha
अन्धाधुन्ध	andhaadhundh
अन्धानुकरण	andhaanukaran
अन्धे	andhe
अन्धेर	andher
अन्धेरा	andhera
अन्न	ann
अन्नकूट	annakoot
अन्नदाता	annadaata
अन्नपूर्णा	annapoorna
अन्नप्राशन	annapraashan
अन्नमय	annamay
अन्ना	anna
अन्नागार	annaagaar
अन्नादुरै	annaadurai
अन्नान	annaan
अन्नामलाई	annaamalaee
अन्नाराम	annaaraam
अन्य	any
अन्यजातियों	anyajaatiyon
अन्यतम	anyatam
अन्यत्र	anyatr
अन्यत्रता	anyatrata
अन्यथा	anyatha
अन्यदेशीय	anyadesheey
अन्यमनस्कता	anyamanaskata
अन्यान्य	anyaany
अन्याय	anyaay
अन्यायपूर्ण	anyaayapoorn
अन्यायपूर्णता	anyaayapoornata
अन्यायी	anyaayee
अन्यायों	anyaayon
अन्यों	anyon
अन्योन्यक्रिया	anyonyakriya
अन्योन्याश्रय	anyonyaashray
अन्योन्याश्रित	anyonyaashrit
अन्वेशण	anveshan
अन्वेषक	anveshak
अन्वेषकों	anveshakon
अन्वेषण	anveshan
अन्वेषणशील	anveshanasheel
अन्वेषणात्मक	anveshanaatmak
अन्वेषणों	anveshanon
अन्वेषित	anveshit
अन्वेषी	anveshee
अनफ़िप	anafip
अनफ़िल्टर्ड	anafiltard
अनफ़ैशनेबल	anafaishanebal
अप	ap
अपंग	apang
अपंगता	apangata
अपंजीकृत	apanjeekrt
अपकरण	apakaran
अपकर्मी	apakarmee
अपकर्ष	apakarsh
अपकर्षक	apakarshak
अपकर्षण	apakarshan
अपकर्षिणी	apakarshinee
अपकर्षी	apakarshee
अपकलंक	apakalank
अपकार	apakaar
अपकारक	apakaarak
अपकारिता	apakaarita
अपकारी	apakaaree
अपकीरति	apakeerati
अपकीर्ण	apakeern
अपकीर्ति	apakeerti
अपकीर्तिकर	apakeertikar
अपकृत	apakrt
अपकृत्य	apakrty
अपकृष्टता	apakrshtata
अपकेंद्र	apakendr
अपकेंद्री	apakendree
अपक्व	apakv
अपक्वता	apakvata
अपक्षपात	apakshapaat
अपक्षय	apakshay
अपक्षयण	apakshayan
अपक्षयी	apakshayee
अपक्षरणीय	apaksharaneey
अपक्षीणन	apaksheenan
अपगति	apagati
अपग्रेड	apagred
अपघटन	apaghatan
अपघर्षक	apagharshak
अपघर्षी	apagharshee
अपच	apach
अपचय	apachay
अपचयन	apachayan
अपचार	apachaar
अपचारी	apachaaree
अपचित	apachit
अपच्छेदन	apachchhedan
अपछरा	apachhara
अपजनन	apajanan
अपटु	apatu
अपटुता	apatuta
अपठनीय	apathaneey
अपठित	apathit
अपडेट	apadet
अपत	apat
अपतट	apatat
अपतटीय	apatateey
अपतुष्टि	apatushti
अपथ्य	apathy
अपदस्थ	apadasth
अपद्रव्यों	apadravyon
अपन	apan
अपनत	apanat
अपनत्व	apanatv
अपनयन	apanayan
अपना	apana
अपनाई	apanaee
अपनाए	apanae
अपनाएं	apanaen
अपनाएगा	apanaega
अपनाएगी	apanaegee
अपनाकर	apanaakar
अपनाता	apanaata
अपनाती	apanaatee
अपनाते	apanaate
अपनाना	apanaana
अपनानी	apanaanee
अपनाने	apanaane
अपनापन	apanaapan
अपनाम	apanaam
अपनाया	apanaaya
अपनायी	apanaayee
अपनाये	apanaaye
अपनी	apanee
अपनीत	apaneet
अपने	apane
अपनें	apanen
अपनेआप	apaneaap
अपनेपन	apanepan
अपनों	apanon
अपभ्रंश	apabhransh
अपमान	apamaan
अपमानजनक	apamaanajanak
अपमानसूचक	apamaanasoochak
अपमानित	apamaanit
अपमिश्रित	apamishrit
अपमुखी	apamukhee
अपयश	apayash
अपयशकारी	apayashakaaree
अपर	apar
अपरंपरागतता	aparamparaagatata
अपरंपार	aparampaar
अपरचना	aparachana
अपरता	aparata
अपरद	aparad
अपरदन	aparadan
अपरमपार	aparamapaar
अपरम्परागत	aparamparaagat
अपरम्पार	aparampaar
अपररूपता	apararoopata
अपरसायनविद	aparasaayanavid
अपरा	apara
अपराइट	aparait
अपराजिता	aparaajita
अपराजितो	aparaajito
अपराजेय	aparaajey
अपराजेयता	aparaajeyata
अपराध	aparaadh
अपराधबोध	aparaadhabodh
अपराधिक	aparaadhik
अपराधियों	aparaadhiyon
अपराधी	aparaadhee
अपराधीकरण	aparaadheekaran
अपराधों	aparaadhon
अपरान्ह	aparaanh
अपरामर्श्य	aparaamarshy
अपरावर्तित	aparaavartit
अपराह्न	aparaahn
अपरिग्रह	aparigrah
अपरिचित	aparichit
अपरिचितता	aparichitata
अपरिचितों	aparichiton
अपरिणीता	aparineeta
अपरिपक्व	aparipakv
अपरिपक्वता	aparipakvata
अपरिभाषित	aparibhaashit
अपरिभाष्य	aparibhaashy
अपरिमित	aparimit
अपरिमेय	aparimey
अपरिवर्तनवादी	aparivartanavaadee
अपरिवर्तनीय	aparivartaneey
अपरिवर्तनीयता	aparivartaneeyata
अपरिवर्तित	aparivartit
अपरिवर्ती	aparivartee
अपरिवर्त्य	aparivarty
अपरिशोधित	aparishodhit
अपरिष्कृत	aparishkrt
अपरिष्कृतता	aparishkrtata
अपरिहारित	aparihaarit
अपरिहार्य	aparihaary
अपरिहास	aparihaas
अपरूप	aparoop
अपरूपक	aparoopak
अपरूपता	aparoopata
अपरोक्ष	aparoksh
अपर्णा	aparna
अपर्याप्त	aparyaapt
अपर्याप्तता	aparyaaptata
अपर्याप्ति	aparyaapti
अपलक्षण	apalakshan
अपलाभ	apalaabh
अपलिंक	apalink
अपलैंड	apalaind
अपलोक	apalok
अपलोड	apalod
अपवंचन	apavanchan
अपवर्ग	apavarg
अपवर्जक	apavarjak
अपवर्जन	apavarjan
अपवर्जित	apavarjit
अपवर्ज्य	apavarjy
अपवर्तक	apavartak
अपवर्तन	apavartan
अपवर्तनांक	apavartanaank
अपवर्तनी	apavartanee
अपवर्तित	apavartit
अपवर्त्य	apavarty
अपवहन	apavahan
अपवाद	apavaad
अपवादिक	apavaadik
अपवादित	apavaadit
अपवादों	apavaadon
अपवाह	apavaah
अपविक्रय	apavikray
अपवित्र	apavitr
अपवित्रकारी	apavitrakaaree
अपवित्रा	apavitra
अपवित्रीकरण	apavitreekaran
अपव्यय	apavyay
अपव्ययी	apavyayee
अपशंक	apashank
अपशकुन	apashakun
अपशगुन	apashagun
अपशब्द	apashabd
अपशब्दपूर्ण	apashabdapoorn
अपशब्दों	apashabdon
अपशिष्ट	apashisht
अपश्रुति	apashruti
अपसंदर्भन	apasandarbhan
अपसव्य	apasavy
अपसामान्य	apasaamaany
अपसामान्यता	apasaamaanyata
अपसारक	apasaarak
अपसारण	apasaaran
अपसारित	apasaarit
अपसारी	apasaaree
अपसौर	apasaur
अपस्टार्ट	apastaart
अपस्ट्रोक	apastrok
अपस्फीत	apaspheet
अपस्मृति	apasmrti
अपस्वार्थी	apasvaarthee
अपहरण	apaharan
अपहरणकर्ता	apaharanakarta
अपहर्ता	apaharta
अपहर्ताओं	apahartaon
अपहानि	apahaani
अपहारक	apahaarak
अपहृत	apahrt
अपह्रत	apahrat
अपाकरण	apaakaran
अपाची	apaachee
अपाचे	apaache
अपात्र	apaatr
अपात्रता	apaatrata
अपान	apaan
अपामार्ग	apaamaarg
अपार	apaar
अपारदर्शिता	apaaradarshita
अपारदर्शी	apaaradarshee
अपारा	apaara
अपारिवारिक	apaarivaarik
अपार्टमेंट	apaartament
अपार्टमेंट	apaartament
अपार्टमेन्ट	apaartament
अपार्ट्मेंट	apaartment
अपार्यता	apaaryata
अपालतू	apaalatoo
अपावन	apaavan
अपावर्तक	apaavartak
अपाहिज	apaahij
अपितु	apitu
अपित्त	apitt
अपिपासा	apipaasa
अपील	apeel
अपीलकर्ता	apeelakarta
अपीलकर्ताआ	apeelakartaa
अपीलार्थी	apeelaarthee
अपीली	apeelee
अपीलीय	apeeleey
अपीलें	apeelen
अपीलों	apeelon
अपुत्रक	aputrak
अपुष्ट	apusht
अपुष्टिकर	apushtikar
अपुष्पी	apushpee
अपूप	apoop
अपूयन	apooyan
अपूरणीय	apooraneey
अपूर्ण	apoorn
अपूर्णता	apoornata
अपूर्य	apoory
अपूर्व	apoorv
अपूर्वकथित	apoorvakathit
अपूर्वता	apoorvata
अपूर्वतासे	apoorvataase
अपूर्वदृष्ट	apoorvadrsht
अपूर्वा	apoorva
अपूर्वाग्रही	apoorvaagrahee
अपूर्वानुमानित	apoorvaanumaanit
अपूर्वानुमेय	apoorvaanumey
अपूर्वानुमेयता	apoorvaanumeyata
अपेक्षणीय	apekshaneey
अपेक्षतया	apekshataya
अपेक्षया	apekshaya
अपेक्षा	apeksha
अपेक्षाएं	apekshaen
अपेक्षाओं	apekshaon
अपेक्षाकृत	apekshaakrt
अपेक्षित	apekshit
अपेक्षी	apekshee
अपेक्ष्य	apekshy
अपॉइंटमेंट	apointament
अपॉन	apon
अपोलो	apolo
अपोहक	apohak
अपोहन	apohan
अप्पन	appan
अप्पा	appa
अप्पू	appoo
अप्रकाश	aprakaash
अप्रकाशनीय	aprakaashaneey
अप्रकाशित	aprakaashit
अप्रकाश्य	aprakaashy
अप्रकृत	aprakrt
अप्रचलन	aprachalan
अप्रचलित	aprachalit
अप्रचार	aprachaar
अप्रतिकार	apratikaar
अप्रतिकार्य	apratikaary
अप्रतिक्रियात्मक	apratikriyaatmak
अप्रतिक्रियाशील	apratikriyaasheel
अप्रतिक्रियाशीलता	apratikriyaasheelata
अप्रतिज्ञाबद्ध	apratigyaabaddh
अप्रतिदेय	apratidey
अप्रतिनिधिक	apratinidhik
अप्रतिबंधात्मक	apratibandhaatmak
अप्रतिबंधित	apratibandhit
अप्रतिबद्ध	apratibaddh
अप्रतिबन्ध	apratibandh
अप्रतिबन्धित	apratibandhit
अप्रतिभ	apratibh
अप्रतिभागित	apratibhaagit
अप्रतिभाव्य	apratibhaavy
अप्रतिम	apratim
अप्रतियोगितात्मक	apratiyogitaatmak
अप्रतिरथ	apratirath
अप्रतिरोध	apratirodh
अप्रतिरोधी	apratirodhee
अप्रतिवादित	aprativaadit
अप्रतिवादी	aprativaadee
अप्रतिवाद्य	aprativaady
अप्रतिवेदित	aprativedit
अप्रतिवेद्य	aprativedy
अप्रतिशोधित	apratishodhit
अप्रतिशोधी	apratishodhee
अप्रतिष्ठा	apratishtha
अप्रतिष्ठाकर	apratishthaakar
अप्रतिष्ठाकारी	apratishthaakaaree
अप्रतिष्ठित	apratishthit
अप्रतिसंहरणीय	apratisanharaneey
अप्रतिस्थाप्य	apratisthaapy
अप्रतिस्पर्धात्मक	apratispardhaatmak
अप्रतिहत	apratihat
अप्रत्यक्ष	apratyaksh
अप्रत्यक्षता	apratyakshata
अप्रत्यय	apratyay
अप्रत्यायक	apratyaayak
अप्रत्यार्पणीय	apratyaarpaneey
अप्रत्याशित	apratyaashit
अप्रत्य्क्ष	apratyksh
अप्रदत्त	apradatt
अप्रदर्शनशील	apradarshanasheel
अप्रधान	apradhaan
अप्रभावनीय	aprabhaavaneey
अप्रभावशाली	aprabhaavashaalee
अप्रभावशील	aprabhaavasheel
अप्रभावित	aprabhaavit
अप्रभावी	aprabhaavee
अप्रभाव्य	aprabhaavy
अप्रभाव्यता	aprabhaavyata
अप्रभेद्य	aprabhedy
अप्रमाण	apramaan
अप्रमाणिकता	apramaanikata
अप्रमाण्य	apramaany
अप्रयुक्त	aprayukt
अप्रयोग	aprayog
अप्रयोगात्मक	aprayogaatmak
अप्रयोगावस्था	aprayogaavastha
अप्रयोज्य	aprayojy
अप्रवर्तनीय	apravartaneey
अप्रवर्ती	apravartee
अप्रवास	apravaas
अप्रवासन	apravaasan
अप्रवासियों	apravaasiyon
अप्रवासी	apravaasee
अप्रवृत	apravrt
अप्रवेश्य	apraveshy
अप्रवेश्यता	apraveshyata
अप्रशंसनीय	aprashansaneey
अप्रशम्य	aprashamy
अप्रशिक्षित	aprashikshit
अप्रसन्न	aprasann
अप्रसन्नता	aprasannata
अप्रसन्नतापूर्वक	aprasannataapoorvak
अप्रसाद	aprasaad
अप्रसार	aprasaar
अप्रसारित	aprasaarit
अप्रस्तुत	aprastut
अप्रस्न्न	aprasnn
अप्राकाम्य	apraakaamy
अप्राकृतिक	apraakrtik
अप्राक्कथनीयता	apraakkathaneeyata
अप्राप्त	apraapt
अप्राप्तलक्ष्य	apraaptalakshy
अप्राप्तवय	apraaptavay
अप्राप्तवयस्क	apraaptavayask
अप्राप्य	apraapy
अप्राप्यता	apraapyata
अप्रायिक	apraayik
अप्रार्थित	apraarthit
अप्रासंगिक	apraasangik
अप्रासंगिकता	apraasangikata
अप्रिय	apriy
अप्रियता	apriyata
अप्रेंटिस	aprentis
अप्रेरक	aprerak
अप्रेरित	aprerit
अप्रेल	aprel
अप्रैल	aprail
अप्रोच	aproch
अप्रौढ़	apraudh
अप्लाइड	aplaid
अप्लिकेशन	aplikeshan
अप्सरा	apsara
अप्सराएँ	apsaraen
अप्सराओं	apsaraon
अपढ़	apadh
अफ	aph
अफगान	aphagaan
अफगानिस्तान	aphagaanistaan
अफगानी	aphagaanee
अफगानों	aphagaanon
अफजल	aphajal
अफरा	aphara
अफराना	apharaana
अफवाह	aphavaah
अफवाहें	aphavaahen
अफवाहों	aphavaahon
अफसर	aphasar
अफसरशाही	aphasarashaahee
अफसरी	aphasaree
अफसरों	aphasaron
अफसाना	aphasaana
अफसोस	aphasos
अफारा	aphaara
अफीम	apheem
अफेयर्स	apheyars
अफ्रिका	aphrika
अफ्रीकन	aphreekan
अफ्रीका	aphreeka
अफ्रीकांस	aphreekaans
अफ्रीकियों	aphreekiyon
अफ्रीकी	aphreekee
अब	ab
अबंधकित	abandhakit
अबकी	abakee
अबके	abake
अबखाजिया	abakhaajiya
अबतक	abatak
अबरार	abaraar
अबरी	abaree
अबरक़	abaraq
अबल	abal
अबला	abala
अबा	aba
अबाउट	abaut
अबाध	abaadh
अबाधित	abaadhit
अबाबा	abaaba
अबिजान	abijaan
अबीजीय	abeejeey
अबीर	abeer
अबीसीनिया	abeeseeniya
अबु	abu
अबुध	abudh
अबुल	abul
अबू	aboo
अबूजा	abooja
अबूझ	aboojh
अबूझमाड़	aboojhamaad
अबूझा	aboojha
अबे	abe
अबै	abai
अबोध	abodh
अबोधता	abodhata
अबोध्य	abodhy
अबोध्यता	abodhyata
अब्जद	abjad
अब्जिनी	abjinee
अब्दाली	abdaalee
अब्दुर	abdur
अब्दुर्रहमान	abdurrahamaan
अब्दुल	abdul
अब्दुल्ला	abdulla
अब्दुल्लाह	abdullaah
अब्बा	abba
अब्बाजान	abbaajaan
अब्बास	abbaas
अब्बासी	abbaasee
अब्बे	abbe
अब्राम	abraam
अब्राहम	abraaham
अब्राह्मण	abraahman
अब्रूज़ी	abroozee
अभंग	abhang
अभंजनीयता	abhanjaneeyata
अभक्ति	abhakti
अभगत	abhagat
अभद्र	abhadr
अभद्रता	abhadrata
अभय	abhay
अभयदान	abhayadaan
अभयपत्र	abhayapatr
अभयपुर	abhayapur
अभयप्रद	abhayaprad
अभयारण्य	abhayaarany
अभयारण्यों	abhayaaranyon
अभर	abhar
अभरक	abharak
अभागा	abhaaga
अभागिन	abhaagin
अभागिनि	abhaagini
अभागी	abhaagee
अभागे	abhaage
अभागों	abhaagon
अभाग्य	abhaagy
अभारित	abhaarit
अभाव	abhaav
अभावग्रस्त	abhaavagrast
अभावात्मक	abhaavaatmak
अभावों	abhaavon
अभास	abhaas
अभि	abhi
अभिकरण	abhikaran
अभिकर्ता	abhikarta
अभिकर्ताओं	abhikartaon
अभिकर्मक	abhikarmak
अभिकर्मकों	abhikarmakon
अभिकलक	abhikalak
अभिकलन	abhikalan
अभिकल्प	abhikalp
अभिकल्पक	abhikalpak
अभिकल्पन	abhikalpan
अभिकल्पना	abhikalpana
अभिकल्पित	abhikalpit
अभिकारक	abhikaarak
अभिक्रिया	abhikriya
अभिक्रियाएँ	abhikriyaen
अभिक्रियाएं	abhikriyaen
अभिक्रियाओं	abhikriyaon
अभिक्रियाशील	abhikriyaasheel
अभिक्षमता	abhikshamata
अभिगणना	abhiganana
अभिगम	abhigam
अभिगमन	abhigaman
अभिगम्य	abhigamy
अभिगम्यता	abhigamyata
अभिग्रहण	abhigrahan
अभिग्रहणशील	abhigrahanasheel
अभिघात	abhighaat
अभिघातक	abhighaatak
अभिघातज	abhighaataj
अभिघातजन्य	abhighaatajany
अभिघातविज्ञान	abhighaatavigyaan
अभिचार	abhichaar
अभिजन	abhijan
अभिजनक	abhijanak
अभिजात	abhijaat
अभिजाततंत्र	abhijaatatantr
अभिजातवाद	abhijaatavaad
अभिजाति	abhijaati
अभिजातीयकरण	abhijaateeyakaran
अभिजात्य	abhijaaty
अभिजित	abhijit
अभिजित्	abhijit
अभिजीत	abhijeet
अभिज्ञ	abhigy
अभिज्ञता	abhigyata
अभिज्ञात	abhigyaat
अभिज्ञान	abhigyaan
अभित्रास	abhitraas
अभिदत्त	abhidatt
अभिदाता	abhidaata
अभिदान	abhidaan
अभिदान	abhidaan
अभिदायी	abhidaayee
अभिद्रोह	abhidroh
अभिद्वार	abhidvaar
अभिनंदन	abhinandan
अभिनंदी	abhinandee
अभिनति	abhinati
अभिनन्दन	abhinandan
अभिनन्दनपत्र	abhinandanapatr
अभिनय	abhinay
अभिनव	abhinav
अभिनियम	abhiniyam
अभिनिर्णय	abhinirnay
अभिनिर्णायक	abhinirnaayak
अभिनिर्धारण	abhinirdhaaran
अभिनिर्धारित	abhinirdhaarit
अभिनीत	abhineet
अभिनीति	abhineeti
अभिनेट्री	abhinetree
अभिनेता	abhineta
अभिनेताओं	abhinetaon
अभिनेत्रियों	abhinetriyon
अभिनेत्री	abhinetree
अभिन्न	abhinn
अभिन्यास	abhinyaas
अभिप्राप्त	abhipraapt
अभिप्राप्य	abhipraapy
अभिप्राय	abhipraay
अभिप्रायपूर्ण	abhipraayapoorn
अभिप्रायानुसार	abhipraayaanusaar
अभिप्रेत	abhipret
अभिप्रेरक	abhiprerak
अभिप्रेरण	abhipreran
अभिभव	abhibhav
अभिभाव	abhibhaav
अभिभावक	abhibhaavak
अभिभावकता	abhibhaavakata
अभिभावकहीन	abhibhaavakaheen
अभिभावकों	abhibhaavakon
अभिभाषक	abhibhaashak
अभिभाषण	abhibhaashan
अभिभूत	abhibhoot
अभिमंत्रित	abhimantrit
अभिमत	abhimat
अभिमन्यु	abhimanyu
अभिमान	abhimaan
अभिमानपूर्वक	abhimaanapoorvak
अभिमानरहित	abhimaanarahit
अभिमानी	abhimaanee
अभियंता	abhiyanta
अभियंताओं	abhiyantaon
अभियंत्रण	abhiyantran
अभियन्ता	abhiyanta
अभियांत्रिकी	abhiyaantrikee
अभियाचना	abhiyaachana
अभियान	abhiyaan
अभियानों	abhiyaanon
अभियान्त्रिकी	abhiyaantrikee
अभियुक्त	abhiyukt
अभियुक्ति	abhiyukti
अभियुक्तों	abhiyukton
अभियोक्ता	abhiyokta
अभियोक्तृ	abhiyoktr
अभियोक्त्री	abhiyoktree
अभियोगी	abhiyogee
अभियोजक	abhiyojak
अभियोजकीय	abhiyojakeey
अभियोजकों	abhiyojakon
अभियोजन	abhiyojan
अभियोजित	abhiyojit
अभियोज्य	abhiyojy
अभियोज्यता	abhiyojyata
अभिरंजक	abhiranjak
अभिरंजित	abhiranjit
अभिरक्षक	abhirakshak
अभिरक्षण	abhirakshan
अभिरक्षा	abhiraksha
अभिरक्षित	abhirakshit
अभिराम	abhiraam
अभिरुचि	abhiruchi
अभिरूचि	abhiroochi
अभिलंबता	abhilambata
अभिलक्षण	abhilakshan
अभिलक्षणों	abhilakshanon
अभिलषित	abhilashit
अभिलाष	abhilaash
अभिलाषा	abhilaasha
अभिलाषाओं	abhilaashaon
अभिलाषित	abhilaashit
अभिलाषी	abhilaashee
अभिलाषीना	abhilaasheena
अभिलिखित	abhilikhit
अभिलेख	abhilekh
अभिलेखक	abhilekhak
अभिलेखन	abhilekhan
अभिलेखपाल	abhilekhapaal
अभिलेखागार	abhilekhaagaar
अभिलेखाध्यक्ष	abhilekhaadhyaksh
अभिलेखानुसार	abhilekhaanusaar
अभिलेखित	abhilekhit
अभिलेखी	abhilekhee
अभिलेखीय	abhilekheey
अभिलेखों	abhilekhon
अभिवंद्य	abhivandy
अभिवर्तक	abhivartak
अभिवर्धित	abhivardhit
अभिवर्धी	abhivardhee
अभिवादन	abhivaadan
अभिवादित	abhivaadit
अभिवाद्य	abhivaady
अभिवाह	abhivaah
अभिवाही	abhivaahee
अभिविन्यास	abhivinyaas
अभिवृत्ति	abhivrtti
अभिवृद्धि	abhivrddhi
अभिव्यंजक	abhivyanjak
अभिव्यंजकता	abhivyanjakata
अभिव्यंजना	abhivyanjana
अभिव्यंजनावाद	abhivyanjanaavaad
अभिव्यंजनावादी	abhivyanjanaavaadee
अभिव्यक्त	abhivyakt
अभिव्यक्ति	abhivyakti
अभिव्यक्तियाँ	abhivyaktiyaan
अभिव्यक्तियां	abhivyaktiyaan
अभिव्यक्तियों	abhivyaktiyon
अभिव्यक्तिशील	abhivyaktisheel
अभिशंसन	abhishansan
अभिशप	abhishap
अभिशप्त	abhishapt
अभिशाप	abhishaap
अभिशापित	abhishaapit
अभिशासन	abhishaasan
अभिशासित	abhishaasit
अभिषंगी	abhishangee
अभिषद	abhishad
अभिषिक्त	abhishikt
अभिषेक	abhishek
अभिषेक्ता	abhishekta
अभिसमय	abhisamay
अभिसरण	abhisaran
अभिसार	abhisaar
अभिसारिका	abhisaarika
अभिसारी	abhisaaree
अभिसूचक	abhisoochak
अभिस्वीकृति	abhisveekrti
अभिहस्तांकन	abhihastaankan
अभिहस्तांतरक	abhihastaantarak
अभिहित	abhihit
अभी	abhee
अभीत	abheet
अभीप्सा	abheepsa
अभीप्सित	abheepsit
अभीप्सु	abheepsu
अभीर	abheer
अभीष्ट	abheesht
अभूत	abhoot
अभूतपूर्व	abhootapoorv
अभेद	abhed
अभेद्य	abhedy
अभेद्यता	abhedyata
अभोगी	abhogee
अभोजित	abhojit
अभोज्य	abhojy
अभ्यर्थियों	abhyarthiyon
अभ्यर्थी	abhyarthee
अभ्यस्त	abhyast
अभ्यारण	abhyaaran
अभ्यारण्य	abhyaarany
अभ्यारोपणीय	abhyaaropaneey
अभ्यारोप्य	abhyaaropy
अभ्यावेदक	abhyaavedak
अभ्यावेदन	abhyaavedan
अभ्यास	abhyaas
अभ्यासकार्य	abhyaasakaary
अभ्यासगत	abhyaasagat
अभ्यासों	abhyaason
अभ्युदय	abhyuday
अभ्रक	abhrak
अभ्रांत	abhraant
अभ्रोत्थ	abhrotth
अमंगल	amangal
अमंगलसूचक	amangalasoochak
अमकट	amakat
अमचूर	amachoor
अमजद	amajad
अमत्त	amatt
अमत्तता	amattata
अमन	aman
अमनपसंद	amanapasand
अमनपसंदवाद	amanapasandavaad
अमनोहर	amanohar
अमर	amar
अमरकंटक	amarakantak
अमरकांत	amarakaant
अमरकोष	amarakosh
अमरजीत	amarajeet
अमरता	amarata
अमरत्व	amaratv
अमरनाथ	amaranaath
अमरपक्षी	amarapakshee
अमरपुर	amarapur
अमरबेल	amarabel
अमरसिंह	amarasinh
अमरा	amara
अमराचार्य	amaraachaary
अमरापुरकर	amaraapurakar
अमरावती	amaraavatee
अमरिंदर	amarindar
अमरिका	amarika
अमरिकी	amarikee
अमरी	amaree
अमरीकन	amareekan
अमरीका	amareeka
अमरीकियों	amareekiyon
अमरीकी	amareekee
अमरीश	amareesh
अमरुद	amarud
अमरूद	amarood
अमरेन्द्र	amarendr
अमरेली	amarelee
अमरेश	amaresh
अमरेश्वर	amareshvar
अमरोहा	amaroha
अमरौली	amaraulee
अमर्त्य	amarty
अमर्यादा	amaryaada
अमर्यादाशील	amaryaadaasheel
अमर्यादित	amaryaadit
अमर्ष	amarsh
अमल	amal
अमलतास	amalataas
अमलतासी	amalataasee
अमला	amala
अमशीनी	amasheenee
अमांडा	amaanda
अमान	amaan
अमानक	amaanak
अमानत	amaanat
अमाननीय	amaananeey
अमानवीय	amaanaveey
अमानवीयता	amaanaveeyata
अमाना	amaana
अमानी	amaanee
अमानुषिकता	amaanushikata
अमानुषी	amaanushee
अमान्य	amaany
अमान्यकरण	amaanyakaran
अमान्यकरणीय	amaanyakaraneey
अमान्यता	amaanyata
अमान्यताप्राप्त	amaanyataapraapt
अमार	amaar
अमावस	amaavas
अमावस्या	amaavasya
अमाशय	amaashay
अमिट	amit
अमित	amit
अमिता	amita
अमिताभ	amitaabh
अमित्र	amitr
अमित्रतापूर्ण	amitrataapoorn
अमित्रवत	amitravat
अमिय	amiy
अमिया	amiya
अमिर	amir
अमिल	amil
अमी	amee
अमीचंद	ameechand
अमीटर	ameetar
अमीन	ameen
अमीना	ameena
अमीनाबाद	ameenaabaad
अमीनो	ameeno
अमीबा	ameeba
अमीर	ameer
अमीरात	ameeraat
अमीरी	ameeree
अमीरों	ameeron
अमुक	amuk
अमुक्त	amukt
अमुख	amukh
अमुद्रणीय	amudraneey
अमूत्रता	amootrata
अमूमन	amooman
अमूर्त	amoort
अमूर्तता	amoortata
अमूर्तन	amoortan
अमूर्तवाद	amoortavaad
अमूर्तवादी	amoortavaadee
अमूल	amool
अमूलक	amoolak
अमूल्य	amooly
अमूल्यता	amoolyata
अमृत	amrt
अमृतधारा	amrtadhaara
अमृतपुर	amrtapur
अमृतमय	amrtamay
अमृतराज	amrtaraaj
अमृतलाल	amrtalaal
अमृतवाणी	amrtavaanee
अमृतसर	amrtasar
अमृता	amrta
अमृतेशय	amrteshay
अमेंडा	amenda
अमेजन	amejan
अमेठना	amethana
अमेठी	amethee
अमेरिकन	amerikan
अमेरिका	amerika
अमेरिकावासी	amerikaavaasee
अमेरिकास	amerikaas
अमेरिकियों	amerikiyon
अमेरिकी	amerikee
अमेरिकीकरण	amerikeekaran
अमेरीका	amereeka
अमेल	amel
अमेज़न	amezan
अमेज़िंग	amezing
अमोघ	amogh
अमोघवर्ष	amoghavarsh
अमोचनीय	amochaneey
अमोनियम	amoniyam
अमोनिया	amoniya
अमोल	amol
अमोला	amola
अमोली	amolee
अमौखिक	amaukhik
अमौलिक	amaulik
अमौलिकता	amaulikata
अम्पायर	ampaayar
अम्बर	ambar
अम्बरीष	ambareesh
अम्बष्ठ	ambashth
अम्बा	amba
अम्बार	ambaar
अम्बाला	ambaala
अम्बालिका	ambaalika
अम्बिका	ambika
अम्बिकापुर	ambikaapur
अम्बे	ambe
अम्बेडकर	ambedakar
अम्मा	amma
अम्माँ	ammaan
अम्मान	ammaan
अम्मी	ammee
अम्मोनियों	ammoniyon
अम्ल	aml
अम्लजन	amlajan
अम्लता	amlata
अम्लनाशक	amlanaashak
अम्लपित्त	amlapitt
अम्लमयता	amlamayata
अम्लमितीय	amlamiteey
अम्लरक्तता	amlaraktata
अम्लशूल	amlashool
अम्लान	amlaan
अम्लापकर्षक	amlaapakarshak
अम्लीकरण	amleekaran
अम्लीकरण्	amleekaran
अम्लीकृत	amleekrt
अम्लीभवन	amleebhavan
अम्लीय	amleey
अम्लीयता	amleeyata
अम्लों	amlon
अम्हौरी	amhauree
अमज़द	amazad
अयंत्रचालित	ayantrachaalit
अयंत्रित	ayantrit
अयथार्थ	ayathaarth
अयथार्थता	ayathaarthata
अयथार्थवाद	ayathaarthavaad
अयथार्थवादी	ayathaarthavaadee
अयन	ayan
अयनांत	ayanaant
अयश	ayash
अयशस्कर	ayashaskar
अयस्क	ayask
अयाजक	ayaajak
अयातुल्ला	ayaatulla
अयान	ayaan
अयाना	ayaana
अयाल	ayaal
अयुक्तता	ayuktata
अयुग्म	ayugm
अयुग्मक	ayugmak
अयुत	ayut
अयूथचर	ayoothachar
अयूब	ayoob
अयोग	ayog
अयोग्य	ayogy
अयोग्यता	ayogyata
अयोध्या	ayodhya
अयोध्याकाण्ड	ayodhyaakaand
अयोध्यासिंह	ayodhyaasinh
अय्यर	ayyar
अय्याशी	ayyaashee
अय्यूब	ayyoob
अर	ar
अरंजित	aranjit
अरंडी	arandee
अरक	arak
अरकांसास	arakaansaas
अरक्तक	araktak
अरक्तता	araktata
अरक्तताजन्य	araktataajany
अरक्षणीय	arakshaneey
अरक्षात्मक	arakshaatmak
अरक्षित	arakshit
अरक्षितता	arakshitata
अरगन	aragan
अरचित	arachit
अरजिस्टरीकृत	arajistareekrt
अरण्डी	arandee
अरण्य	arany
अरथ	arath
अरथी	arathee
अरदली	aradalee
अरदास	aradaas
अरधंग	aradhang
अरना	arana
अरनी	aranee
अरपा	arapa
अरब	arab
अरबपति	arabapati
अरबपतियों	arabapatiyon
अरबस्क	arabask
अरबाज़	arabaaz
अरबिया	arabiya
अरबी	arabee
अरबों	arabon
अरमान	aramaan
अरमानी	aramaanee
अरमानों	aramaanon
अरराना	araraana
अररिया	arariya
अरवल	araval
अरविंद	aravind
अरविन्द	aravind
अरवी	aravee
अरशद	arashad
अरसा	arasa
अरसे	arase
अरस्तु	arastu
अरस्तू	arastoo
अरहर	arahar
अराउंड	araund
अराजक	araajak
अराजकता	araajakata
अराजकतावाद	araajakataavaad
अराजकतावादी	araajakataavaadee
अराजकतावाद्	araajakataavaad
अराजनीतिक	araajaneetik
अराजनीतिज्ञोचित	araajaneetigyochit
अराजनैतिक	araajanaitik
अराजपत्रित	araajapatrit
अराजी	araajee
अराति	araati
अराधना	araadhana
अराफात	araaphaat
अराबा	araaba
अरारोट	araarot
अराल	araal
अरालदंड	araaladand
अरावल	araaval
अरावली	araavalee
अरास	araas
अरि	ari
अरिमर्दन	arimardan
अरिष्ट	arisht
अरिष्टनेमि	arishtanemi
अरिष्टा	arishta
अरिहंत	arihant
अरीय	areey
अरुंधति	arundhati
अरुंधती	arundhatee
अरुचि	aruchi
अरुचिकर	aruchikar
अरुचिकरता	aruchikarata
अरुण	arun
अरुणा	aruna
अरुणांचल	arunaanchal
अरुणाचल	arunaachal
अरुणाश्व	arunaashv
अरुणित	arunit
अरुणिमा	arunima
अरुणोदय	arunoday
अरुन	arun
अरुनारा	arunaara
अरुन्धती	arundhatee
अरूचि	aroochi
अरूचिकर	aroochikar
अरूण	aroon
अरूणाचल	aroonaachal
अरूणिमा	aroonima
अरूप	aroop
अरूढ़िवादी	aroodhivaadee
अरे	are
अरेंजमेंट	arenjament
अरेबियन	arebiyan
अरेराज	areraaj
अरैखिक	araikhik
अरोगी	arogee
अरोचक	arochak
अरोचकता	arochakata
अरोदित	arodit
अरोरा	arora
अरोड़ा	aroda
अर्क	ark
अर्कांसस	arkaansas
अर्ग	arg
अर्गल	argal
अर्गला	argala
अर्गोन	argon
अर्घ	argh
अर्चक	archak
अर्चन	archan
अर्चना	archana
अर्चित	archit
अर्जक	arjak
अर्जन	arjan
अर्जित	arjit
अर्जितश्वित्र	arjitashvitr
अर्जी	arjee
अर्जुन	arjun
अर्जेंट	arjent
अर्जेंटीना	arjenteena
अर्जेंटीनी	arjenteenee
अर्जेटीना	arjeteena
अर्जेण्टीना	arjenteena
अर्जेन्ट	arjent
अर्जेन्टीना	arjenteena
अर्थ	arth
अर्थकर	arthakar
अर्थकार	arthakaar
अर्थतः	arthatah
अर्थदंड	arthadand
अर्थदण्ड	arthadand
अर्थदर्शक	arthadarshak
अर्थनीति	arthaneeti
अर्थपूरण	arthapooran
अर्थपूर्ण	arthapoorn
अर्थपूर्णता	arthapoornata
अर्थपूर्णतासे	arthapoornataase
अर्थमिति	arthamiti
अर्थवत	arthavat
अर्थवत्ता	arthavatta
अर्थविज्ञान	arthavigyaan
अर्थव्यवस्था	arthavyavastha
अर्थव्यवस्थाएँ	arthavyavasthaen
अर्थव्यवस्थाओं	arthavyavasthaon
अर्थव्यस्था	arthavyastha
अर्थशास्त्र	arthashaastr
अर्थशास्त्रियों	arthashaastriyon
अर्थशास्त्री	arthashaastree
अर्थहीन	arthaheen
अर्थहीनता	arthaheenata
अर्थात	arthaat
अर्थात्	arthaat
अर्थिक	arthik
अर्थी	arthee
अर्थो	artho
अर्थों	arthon
अर्थोपाय	arthopaay
अर्थोपार्जन	arthopaarjan
अर्थ्स	arths
अर्द्ध	arddh
अर्द्धचंद्र	arddhachandr
अर्द्धचन्द्र	arddhachandr
अर्द्धचन्द्राकार	arddhachandraakaar
अर्द्धतः	arddhatah
अर्द्धनग्न	arddhanagn
अर्द्धनारीश्वर	arddhanaareeshvar
अर्द्धन्यायिक	arddhanyaayik
अर्द्धपारदर्शी	arddhapaaradarshee
अर्द्धवर्षीय	arddhavarsheey
अर्द्धवार्षिक	arddhavaarshik
अर्द्धविकसित	arddhavikasit
अर्द्धविराम	arddhaviraam
अर्द्धवृत्त	arddhavrtt
अर्द्धशतक	arddhashatak
अर्द्धसाप्ताहिक	arddhasaaptaahik
अर्द्धसैनिक	arddhasainik
अर्द्धांगिनी	arddhaanginee
अर्द्धांश	arddhaansh
अर्ध	ardh
अर्धगोल	ardhagol
अर्धचालक	ardhachaalak
अर्धचालकों	ardhachaalakon
अर्धन	ardhan
अर्धनग्न	ardhanagn
अर्धनारीश्वर	ardhanaareeshvar
अर्धमागधी	ardhamaagadhee
अर्धरात्रि	ardharaatri
अर्धवार्षिक	ardhavaarshik
अर्धविकसित	ardhavikasit
अर्धविराम	ardhaviraam
अर्धविरामों	ardhaviraamon
अर्धशीर्षी	ardhasheershee
अर्धसत्य	ardhasaty
अर्धसैनिक	ardhasainik
अर्धस्वरक	ardhasvarak
अर्धांश	ardhaansh
अर्धाशन	ardhaashan
अर्ध्य	ardhy
अर्नस्ट	arnast
अर्नाल्ड	arnaald
अर्नेस्ट	arnest
अर्नोल्ड	arnold
अर्न्तगत	arntagat
अर्न्स्ट	arnst
अर्पण	arpan
अर्पित	arpit
अर्पिता	arpita
अर्बन	arban
अर्बियम	arbiyam
अर्बुद	arbud
अर्बुदी	arbudee
अर्मेनिया	armeniya
अर्मेनियाई	armeniyaee
अर्लि	arli
अर्ली	arlee
अर्ल्स	arls
अर्वाचीन	arvaacheen
अर्श	arsh
अर्सा	arsa
अर्से	arse
अर्हत	arhat
अर्हता	arhata
अर्हताएं	arhataen
अर्हताओं	arhataon
अर्हताप्राप्त	arhataapraapt
अर्क़	arq
अर्ज़ी	arzee
अर्ज़ीदार	arzeedaar
अलंकरण	alankaran
अलंकरणों	alankaranon
अलंकार	alankaar
अलंकारपूर्ण	alankaarapoorn
अलंकारवाद	alankaaravaad
अलंकारशास्त्र	alankaarashaastr
अलंकारशास्त्रीय	alankaarashaastreey
अलंकारों	alankaaron
अलंकृत	alankrt
अलंकृति	alankrti
अलंग	alang
अलंघनीय	alanghaneey
अलंघनीयता	alanghaneeyata
अलकतरा	alakatara
अलकनंदा	alakananda
अलकनन्दा	alakananda
अलका	alaka
अलकापुरी	alakaapuree
अलकोहल	alakohal
अलक्तक	alaktak
अलक्षण	alakshan
अलक्ष्य	alakshy
अलक्ष्यता	alakshyata
अलख	alakh
अलखधारी	alakhadhaaree
अलखित	alakhit
अलग	alag
अलगनी	alaganee
अलगानेवाला	alagaanevaala
अलगाव	alagaav
अलगाववाद	alagaavavaad
अलगाववादियों	alagaavavaadiyon
अलगाववादी	alagaavavaadee
अलगोजा	alagoja
अलघु	alaghu
अलघुकरणीय	alaghukaraneey
अलज्ज	alajj
अलफांसो	alaphaanso
अलबत्ता	alabatta
अलबम	alabam
अलबर्ट	alabart
अलबर्टा	alabarta
अलबामा	alabaama
अलबेला	alabela
अलबेली	alabelee
अलम	alam
अलमस्त	alamast
अलमस्ती	alamastee
अलमापुर	alamaapur
अलमारियों	alamaariyon
अलमारी	alamaaree
अलमोड़ा	alamoda
अलर्क	alark
अलर्करोग	alarkarog
अलर्ट	alart
अलवर	alavar
अलवा	alava
अलविदा	alavida
अलविधा	alavidha
अलवी	alavee
अलस	alas
अलसर	alasar
अलसाना	alasaana
अलसी	alasee
अलस्टा	alasta
अलहदगी	alahadagee
अलहदा	alahada
अलहम्ब्रा	alahambra
अला	ala
अलाइव	alaiv
अलाउद्दीन	alauddeen
अलादीन	alaadeen
अलान	alaan
अलाप	alaap
अलापना	alaapana
अलापने	alaapane
अलाबू	alaaboo
अलाभ	alaabh
अलाभकर	alaabhakar
अलाभकारिता	alaabhakaarita
अलाभकारी	alaabhakaaree
अलायंस	alaayans
अलार्म	alaarm
अलाव	alaav
अलावलपुर	alaavalapur
अलावा	alaava
अलावे	alaave
अलास्कन	alaaskan
अलास्का	alaaska
अलिंगी	alingee
अलिंद	alind
अलिखित	alikhit
अलिजिह्वाशोथ	alijihvaashoth
अलिप्त	alipt
अलिया	aliya
अली	alee
अलीक	aleek
अलीगंज	aleeganj
अलीगढ	aleegadh
अलीगढ़	aleegadh
अलीनगर	aleenagar
अलीपुर	aleepur
अलीबाबा	aleebaaba
अलीराजपुर	aleeraajapur
अलीशा	aleesha
अलुमनी	alumanee
अलेक्जेंडर	alekjendar
अलेक्जेंड्रिया	alekjendriya
अलेक्टो	alekto
अलेक्सान्द्र	aleksaandr
अलेक्ज़ांडर	alekzaandar
अलेक्ज़ेंडर	alekzendar
अलैंगिक	alaingik
अलैहि	alaihi
अलोक	alok
अलोकतांत्रिक	alokataantrik
अलोकना	alokana
अलोकप्रिय	alokapriy
अलोकप्रियता	alokapriyata
अलोन	alon
अलोप	alop
अलोप्य	alopy
अलोल	alol
अलोलुप	alolup
अलोह	aloh
अलौकिक	alaukik
अलौकिकता	alaukikata
अलौकिकतावाद	alaukikataavaad
अलौकिकतावादी	alaukikataavaadee
अलौली	alaulee
अलौह	alauh
अल्	al
अल्का	alka
अल्केन	alken
अल्कोहल	alkohal
अल्कोहॉल	alkohol
अल्जाइमर	aljaimar
अल्जीयर्स	aljeeyars
अल्जीरिया	aljeeriya
अल्जीरियाई	aljeeriyaee
अल्टरनेटर	altaranetar
अल्टायाक	altaayaak
अल्टिमेटम	altimetam
अल्टीमेट	alteemet
अल्टीमेटम	alteemetam
अल्ट्रा	altra
अल्ट्रावायलेट	altraavaayalet
अल्ट्रासाउंड	altraasaund
अल्ट्रासोनिक	altraasonik
अल्ताई	altaee
अल्ताफ	altaaph
अल्ताफ़	altaaf
अल्प	alp
अल्पक	alpak
अल्पकाल	alpakaal
अल्पकालिक	alpakaalik
अल्पकालीन	alpakaaleen
अल्पज्ञता	alpagyata
अल्पज्ञात	alpagyaat
अल्पतंत्र	alpatantr
अल्पतः	alpatah
अल्पतर	alpatar
अल्पताप	alpataap
अल्पदृष्टि	alpadrshti
अल्पना	alpana
अल्पनिंद्रा	alpanindra
अल्पपोषण	alpaposhan
अल्पपोषित	alpaposhit
अल्पबुद्दि	alpabuddi
अल्पमत	alpamat
अल्पमति	alpamati
अल्पमात्रा	alpamaatra
अल्परूधिरता	alparoodhirata
अल्पविकसित	alpavikasit
अल्पविराम	alpaviraam
अल्पवृत्ति	alpavrtti
अल्पसंख्यक	alpasankhyak
अल्पसंख्यकों	alpasankhyakon
अल्पसंख्या	alpasankhya
अल्पस्थायी	alpasthaayee
अल्पांश	alpaansh
अल्पाइन	alpain
अल्पाम्लता	alpaamlata
अल्पायु	alpaayu
अल्पार्थक	alpaarthak
अल्पावधि	alpaavadhi
अल्पावधिक	alpaavadhik
अल्पाशय	alpaashay
अल्पाहार	alpaahaar
अल्पाहारपूर्ति	alpaahaarapoorti
अल्पाहारिता	alpaahaarita
अल्पाहारी	alpaahaaree
अल्पीकरण	alpeekaran
अल्पेश	alpesh
अल्पोत्पादन	alpotpaadan
अल्फा	alpha
अल्फाल्फा	alphaalpha
अल्फाज़	alphaaz
अल्फ्रेड	alphred
अल्बकोर	albakor
अल्बम	albam
अल्बर्ट	albart
अल्बर्टा	albarta
अल्बर्टो	albarto
अल्बा	alba
अल्बानिया	albaaniya
अल्बानियाई	albaaniyaee
अल्बामा	albaama
अल्बेनियन	albeniyan
अल्मा	alma
अल्माटी	almaatee
अल्मोडा	almoda
अल्मोड़ा	almoda
अल्युमिनियम	alyuminiyam
अल्युमीनियम	alyumeeniyam
अल्यूमीनियम	alyoomeeniyam
अल्ला	alla
अल्लामा	allaama
अल्लाह	allaah
अल्लूरी	allooree
अल्वा	alva
अल्वारेज़	alvaarez
अल्सर	alsar
अल्सेशिअन	alseshian
अल्सेशियन	alseshiyan
अल्स्टर	alstar
अल्हादपूर्ण	alhaadapoorn
अल्हड़	alhad
अल्हड़ी	alhadee
अल्फ़ा	alfa
अल्फ़ान्यूमेरिक	alfaanyoomerik
अलफ़ाज़	alafaaz
अव	av
अवंति	avanti
अवंतिका	avantika
अवंती	avantee
अवकरण	avakaran
अवकर्षण	avakarshan
अवकल	avakal
अवकलन	avakalan
अवकाश	avakaash
अवकाशकालीन	avakaashakaaleen
अवकाशप्राप्त	avakaashapraapt
अवकाशप्राप्ति	avakaashapraapti
अवकीर्ण	avakeern
अवकीर्णन	avakeernan
अवक्रमण	avakraman
अवक्रमित	avakramit
अवक्षय	avakshay
अवक्षेप	avakshep
अवक्षेपण	avakshepan
अवक्षेपित	avakshepit
अवगणित	avaganit
अवगत	avagat
अवगम	avagam
अवगीत	avageet
अवगुंफित	avagumphit
अवगुण	avagun
अवग्रह	avagrah
अवघट	avaghat
अवघूर्णन	avaghoornan
अवचक्र	avachakr
अवचनबद्धता	avachanabaddhata
अवचूर्णित	avachoornit
अवचेतन	avachetan
अवचेतनता	avachetanata
अवच्छेदन	avachchhedan
अवजय	avajay
अवज्ञा	avagya
अवज्ञापूर्वक	avagyaapoorvak
अवटु	avatu
अवढर	avadhar
अवतंस	avatans
अवतर	avatar
अवतरण	avataran
अवतरणों	avataranon
अवतरित	avatarit
अवतल	avatal
अवतलता	avatalata
अवतलन	avatalan
अवतार	avataar
अवतारवाद	avataaravaad
अवतारी	avataaree
अवतारों	avataaron
अवतीर्ण	avateern
अवत्वरण	avatvaran
अवदशा	avadasha
अवदान	avadaan
अवदारित	avadaarit
अवध	avadh
अवधान	avadhaan
अवधार	avadhaar
अवधारक	avadhaarak
अवधारण	avadhaaran
अवधारणा	avadhaarana
अवधारणाएं	avadhaaranaen
अवधारणाओं	avadhaaranaon
अवधारणात्मक	avadhaaranaatmak
अवधारणायें	avadhaaranaayen
अवधारित	avadhaarit
अवधार्य	avadhaary
अवधावन	avadhaavan
अवधि	avadhi
अवधिदान	avadhidaan
अवधियों	avadhiyon
अवधी	avadhee
अवधूत	avadhoot
अवधूपन	avadhoopan
अवधेश	avadhesh
अवनत	avanat
अवनति	avanati
अवनयन	avanayan
अवनि	avani
अवनिप	avanip
अवनिपति	avanipati
अवनी	avanee
अवनीत	avaneet
अवनीश	avaneesh
अवन्ति	avanti
अवपथन	avapathan
अवप्रभार	avaprabhaar
अवप्रेरक	avaprerak
अवबोध	avabodh
अवबोधन	avabodhan
अवभाषित	avabhaashit
अवभासित	avabhaasit
अवभूमि	avabhoomi
अवभृथ	avabhrth
अवमर्षण	avamarshan
अवमल	avamal
अवमानना	avamaanana
अवमुक्त	avamukt
अवमूल्यन	avamoolyan
अवमूल्यित	avamoolyit
अवयव	avayav
अवयवभूत	avayavabhoot
अवयवी	avayavee
अवयवों	avayavon
अवयस्क	avayask
अवयस्कता	avayaskata
अवयस्कों	avayaskon
अवर	avar
अवरक्त	avarakt
अवरति	avarati
अवरधर्मी	avaradharmee
अवरुद्ध	avaruddh
अवरूद्ध	avarooddh
अवरूध्द	avaroodhd
अवरूप	avaroop
अवरोध	avarodh
अवरोधक	avarodhak
अवरोधन	avarodhan
अवरोधित	avarodhit
अवरोधिनी	avarodhinee
अवरोधों	avarodhon
अवरोह	avaroh
अवरोही	avarohee
अवर्गित	avargit
अवर्गीकृत	avargeekrt
अवर्ज्य	avarjy
अवर्ण	avarn
अवर्णता	avarnata
अवर्णनीय	avarnaneey
अवलंब	avalamb
अवलंबन	avalamban
अवलंबी	avalambee
अवलक्ष्य	avalakshy
अवलम्बन	avalamban
अवलेह	avaleh
अवलोकन	avalokan
अवलोकना	avalokana
अवलोकनीय	avalokaneey
अववाहिता	avavaahita
अवश	avash
अवशता	avashata
अवशप्त	avashapt
अवशवर्ती	avashavartee
अवशिष्ट	avashisht
अवशीत	avasheet
अवशेष	avashesh
अवशेषी	avasheshee
अवशेषों	avasheshon
अवशोषक	avashoshak
अवशोषकता	avashoshakata
अवशोषण	avashoshan
अवशोषित	avashoshit
अवशोषी	avashoshee
अवशोष्य	avashoshy
अवश्य	avashy
अवश्यंभावी	avashyambhaavee
अवश्यकता	avashyakata
अवश्यकरणीय	avashyakaraneey
अवश्रव्य	avashravy
अवष्टंभ	avashtambh
अवसंरचना	avasanrachana
अवसर	avasar
अवसरपरक	avasaraparak
अवसरवाद	avasaravaad
अवसरवादिता	avasaravaadita
अवसरवादी	avasaravaadee
अवसरों	avasaron
अवसर्पिणी	avasarpinee
अवसाद	avasaad
अवसादक	avasaadak
अवसादग्रस्त	avasaadagrast
अवसादन	avasaadan
अवसादमय	avasaadamay
अवसादी	avasaadee
अवसादों	avasaadon
अवसान	avasaan
अवसायी	avasaayee
अवस्कर	avaskar
अवस्था	avastha
अवस्थाएँ	avasthaen
अवस्थाएं	avasthaen
अवस्थाओं	avasthaon
अवस्थित	avasthit
अवस्थिति	avasthiti
अवस्थी	avasthee
अवहनन	avahanan
अवहार	avahaar
अवहेलना	avahelana
अवहेलनापूर्ण	avahelanaapoorn
अवहेलनापूर्वक	avahelanaapoorvak
अवांछनीय	avaanchhaneey
अवांछनीयता	avaanchhaneeyata
अवांछित	avaanchhit
अवाई	avaee
अवाक	avaak
अवातित	avaatit
अवाप्त	avaapt
अवाप्ति	avaapti
अवाप्य	avaapy
अवामी	avaamee
अवारणीय	avaaraneey
अवार्ड	avaard
अवार्ड्स	avaards
अवासनीय	avaasaneey
अवासी	avaasee
अवास्तविक	avaastavik
अवास्तविकता	avaastavikata
अवि	avi
अविकसित	avikasit
अविकार	avikaar
अविकारी	avikaaree
अविक्रेय	avikrey
अविगत	avigat
अविचल	avichal
अविचलित	avichalit
अविचलितता	avichalitata
अविच्छिन्नता	avichchhinnata
अविच्छेद्य	avichchhedy
अविजित	avijit
अवितरित	avitarit
अविदग्ध	avidagdh
अविद्यमान	avidyamaan
अविद्या	avidya
अविद्युत	avidyut
अविद्वान	avidvaan
अविद्वेशपूर्ण	avidveshapoorn
अविनय	avinay
अविनाश	avinaash
अविनाशिता	avinaashita
अविनाशी	avinaashee
अविनासी	avinaasee
अविनीत	avineet
अविनीता	avineeta
अविभाजित	avibhaajit
अविभाज्य	avibhaajy
अविभाज्यता	avibhaajyata
अविमुक्त	avimukt
अवियोजित	aviyojit
अवियोज्य	aviyojy
अवियोज्यता	aviyojyata
अविरंजित	aviranjit
अविरत	avirat
अविरल	aviral
अविराम	aviraam
अविलंब	avilamb
अविलंबित	avilambit
अविलपित	avilapit
अविलम्ब	avilamb
अविलेयता	avileyata
अविलोप	avilop
अविवरता	avivarata
अविवादास्पद	avivaadaaspad
अविवादित	avivaadit
अविवाद्य	avivaady
अविवाद्यता	avivaadyata
अविवाहित	avivaahit
अविवाहिता	avivaahita
अविवाहितापन	avivaahitaapan
अविवाहितों	avivaahiton
अविवेक	avivek
अविवेकतापूर्ण	avivekataapoorn
अविवेकपूर्ण	avivekapoorn
अविवेकिता	avivekita
अविवेकी	avivekee
अविवेचना	avivechana
अविवेचित	avivechit
अविवेच्य	avivechy
अविशंकित	avishankit
अविशेष	avishesh
अविशेषज्ञ	avisheshagy
अविशेषणीय	avisheshaneey
अविशेषता	avisheshata
अविशेषित	avisheshit
अविश्ववाद	avishvavaad
अविश्वसनीय	avishvasaneey
अविश्वसनीयता	avishvasaneeyata
अविश्वस्त	avishvast
अविश्वस्तता	avishvastata
अविश्वास	avishvaas
अविश्वासमत	avishvaasamat
अविश्वासी	avishvaasee
अविश्वास्य	avishvaasy
अविषय	avishay
अविष्कार	avishkaar
अविस्मरणीय	avismaraneey
अवीरा	aveera
अवीव	aveev
अवृष्टि	avrshti
अवे	ave
अवेंजर्स	avenjars
अवेक्षण	avekshan
अवेक्षा	aveksha
अवेक्षित	avekshit
अवेत	avet
अवेतनिक	avetanik
अवेध्य	avedhy
अवेरोईज़	averoeez
अवेष्ठित	aveshthit
अवेस्ती	avestee
अवैक्स	avaiks
अवैज्ञानिक	avaigyaanik
अवैतनिक	avaitanik
अवैदिक	avaidik
अवैध	avaidh
अवैधता	avaidhata
अवैधाचरण	avaidhaacharan
अवैधानिक	avaidhaanik
अवैयक्तिक	avaiyaktik
अवैया	avaiya
अवॉर्ड	avord
अवॉर्ड्स	avords
अव्यक्त	avyakt
अव्यक्ता	avyakta
अव्यक्तिगत	avyaktigat
अव्यग्र	avyagr
अव्यय	avyay
अव्यर्थ	avyarth
अव्यवधान	avyavadhaan
अव्यवसायिक	avyavasaayik
अव्यवस्थ	avyavasth
अव्यवस्था	avyavastha
अव्यवस्थित	avyavasthit
अव्यवस्थिततः	avyavasthitatah
अव्यवहारकुशल	avyavahaarakushal
अव्यवहारिक	avyavahaarik
अव्यवहारिकता	avyavahaarikata
अव्यवहार्यता	avyavahaaryata
अव्यवहित	avyavahit
अव्यवह्रत	avyavahrat
अव्यावसायिक	avyaavasaayik
अव्यावसायीकृत	avyaavasaayeekrt
अव्यावहारिक	avyaavahaarik
अव्यावहारिकता	avyaavahaarikata
अव्यूत्पन्न	avyootpann
अव्रोध	avrodh
अव्वल	avval
अश	ash
अशंकनीय	ashankaneey
अशंकनीयता	ashankaneeyata
अशंकालु	ashankaalu
अशंक़	ashanq
अशक्त	ashakt
अशक्तता	ashaktata
अशक्ति	ashakti
अशत	ashat
अशन	ashan
अशनाया	ashanaaya
अशनि	ashani
अशनिपात	ashanipaat
अशफाक	ashaphaak
अशमनीय	ashamaneey
अशरण	asharan
अशरफ	asharaph
अशरफी	asharaphee
अशराफ़	asharaaf
अशरीरिक	ashareerik
अशरफ़	asharaf
अशांत	ashaant
अशांत	ashaant
अशांति	ashaanti
अशांतिपूर्ण	ashaantipoorn
अशांतिप्रिय	ashaantipriy
अशांतिमय	ashaantimay
अशान्त	ashaant
अशान्ति	ashaanti
अशाम्य	ashaamy
अशालीन	ashaaleen
अशालीनता	ashaaleenata
अशासकीय	ashaasakeey
अशासन	ashaasan
अशासनवादी	ashaasanavaadee
अशासनिक	ashaasanik
अशासनीय	ashaasaneey
अशिक्षणीयता	ashikshaneeyata
अशिक्षा	ashiksha
अशिक्षाप्रद	ashikshaaprad
अशिक्षित	ashikshit
अशिथिल	ashithil
अशिष्ट	ashisht
अशिष्टता	ashishtata
अशिष्टतापूर्वक	ashishtataapoorvak
अशिष्टाचार	ashishtaachaar
अशुचि	ashuchi
अशुद्ध	ashuddh
अशुद्धता	ashuddhata
अशुद्धि	ashuddhi
अशुद्धियाँ	ashuddhiyaan
अशुद्धियां	ashuddhiyaan
अशुद्धियों	ashuddhiyon
अशुभ	ashubh
अशुभसूचक	ashubhasoochak
अशून्य	ashoony
अशेष	ashesh
अशेषता	asheshata
अशोक	ashok
अशोकनगर	ashokanagar
अशोका	ashoka
अशोचनीय	ashochaneey
अशोभनीय	ashobhaneey
अशोभनीयता	ashobhaneeyata
अशौच	ashauch
अश्क	ashk
अश्म	ashm
अश्मंत	ashmant
अश्मक	ashmak
अश्मरी	ashmaree
अश्रव्य	ashravy
अश्रव्यता	ashravyata
अश्रु	ashru
अश्रुगैस	ashrugais
अश्रुत	ashrut
अश्रुधारा	ashrudhaara
अश्रुपात	ashrupaat
अश्रुपूरित	ashrupoorit
अश्रुपूर्ण	ashrupoorn
अश्रुपूर्णता	ashrupoornata
अश्रुप्रवण	ashrupravan
अश्रुप्रवाह	ashrupravaah
अश्रेय	ashrey
अश्लिष्ट	ashlisht
अश्लील	ashleel
अश्लीलता	ashleelata
अश्लेषा	ashlesha
अश्व	ashv
अश्वकार	ashvakaar
अश्वगंधा	ashvagandha
अश्वघोष	ashvaghosh
अश्वत्थ	ashvatth
अश्वत्थामा	ashvatthaama
अश्वदल	ashvadal
अश्वधावन	ashvadhaavan
अश्वनी	ashvanee
अश्वपति	ashvapati
अश्वपाल	ashvapaal
अश्वबल	ashvabal
अश्वमांस	ashvamaans
अश्वमेघ	ashvamegh
अश्वमेध	ashvamedh
अश्वशक्ति	ashvashakti
अश्वशावक	ashvashaavak
अश्वश्रुति	ashvashruti
अश्वसेन	ashvasen
अश्वारोह	ashvaaroh
अश्वारोहण	ashvaarohan
अश्वारोही	ashvaarohee
अश्विन	ashvin
अश्विनी	ashvinee
अश्वीय	ashveey
अश्वेत	ashvet
अश्वेतों	ashveton
अशफ़ाक़	ashafaaq
अष्ट	asht
अष्टक	ashtak
अष्टकोण	ashtakon
अष्टकोणीय	ashtakoneey
अष्टकोना	ashtakona
अष्टछाप	ashtachhaap
अष्टधातु	ashtadhaatu
अष्टभुजा	ashtabhuja
अष्टभुजाकार	ashtabhujaakaar
अष्टभुजी	ashtabhujee
अष्टम	ashtam
अष्टमी	ashtamee
अष्टांग	ashtaang
अष्टांगहृदय	ashtaangahrday
अष्टादश	ashtaadash
अष्टाध्यायी	ashtaadhyaayee
अष्टावक्र	ashtaavakr
अस	as
असंक्रामक	asankraamak
असंक्राम्य	asankraamy
असंख्य	asankhy
असंख्येय	asankhyey
असंग	asang
असंगठित	asangathit
असंगत	asangat
असंगतता	asangatata
असंगति	asangati
असंगर्त	asangart
असंघीय	asangheey
असंचालनीय	asanchaalaneey
असंज्ञेय	asangyey
असंत	asant
असंतुलन	asantulan
असंतुलित	asantulit
असंतुलितता	asantulitata
असंतुष्ट	asantusht
असंतुष्टता	asantushtata
असंतुष्टि	asantushti
असंतुष्टिजनक	asantushtijanak
असंतुष्टों	asantushton
असंतुष्य	asantushy
असंतृप्त	asantrpt
असंतोष	asantosh
असंतोषजनक	asantoshajanak
असंतोषी	asantoshee
असंदिग्ध	asandigdh
असंदिग्धता	asandigdhata
असंधित	asandhit
असंपादित	asampaadit
असंपीड्य	asampeedy
असंपुष्ट	asampusht
असंबंधित	asambandhit
असंबंधी	asambandhee
असंबद्ध	asambaddh
असंबद्धवाक	asambaddhavaak
असंभव	asambhav
असंभाव	asambhaav
असंभावना	asambhaavana
असंभावनीय	asambhaavaneey
असंभावित	asambhaavit
असंभाव्य	asambhaavy
असंभाव्यता	asambhaavyata
असंयति	asanyati
असंयम	asanyam
असंयमित	asanyamit
असंरक्षित	asanrakshit
असंरचित	asanrachit
असंरुपित	asanrupit
असंवेदनशील	asanvedanasheel
असंवेदनशीलता	asanvedanasheelata
असंवेद्य	asanvedy
असंवैधानिक	asanvaidhaanik
असंशय	asanshay
असंसदीय	asansadeey
असंस्कृत	asanskrt
असक्षम	asaksham
असगर	asagar
असगरपुर	asagarapur
असजग	asajag
असज्जित	asajjit
असतत	asatat
असतर्क	asatark
असत्य	asaty
असत्यवादी	asatyavaadee
असत्यापित	asatyaapit
असद	asad
असदस्य	asadasy
असनसनीखेज़	asanasaneekhez
असना	asana
असन्तुलित	asantulit
असन्तोष	asantosh
असन्तोषजनक	asantoshajanak
असफल	asaphal
असफलता	asaphalata
असफलताओं	asaphalataon
असफलतापूर्वक	asaphalataapoorvak
असबाब	asabaab
असभ्य	asabhy
असभ्यता	asabhyata
असभ्यतापूर्वक	asabhyataapoorvak
असम	asam
असमंजस	asamanjas
असमतलता	asamatalata
असमता	asamata
असमतापी	asamataapee
असमदूरिक	asamadoorik
असममित	asamamit
असममिति	asamamiti
असममितीय	asamamiteey
असमय	asamay
असमर्थ	asamarth
असमर्थता	asamarthata
असमर्थनशील	asamarthanasheel
असमर्थनीय	asamarthaneey
असमर्थित	asamarthit
असमाजिक	asamaajik
असमान	asamaan
असमानता	asamaanata
असमानताओं	asamaanataon
असमिया	asamiya
असमी	asamee
असमीकरण	asameekaran
असमीक्षात्मक	asameekshaatmak
असम्बद्ध	asambaddh
असम्भव	asambhav
असम्मान	asammaan
असम्मानजनक	asammaanajanak
असम्मानित	asammaanit
असर	asar
असरगंज	asaraganj
असरदार	asaradaar
असरल	asaral
असरलता	asaralata
असरा	asara
असरानी	asaraanee
असल	asal
असलम	asalam
असलियत	asaliyat
असली	asalee
असहज	asahaj
असहजता	asahajata
असहन	asahan
असहनीय	asahaneey
असहमत	asahamat
असहमति	asahamati
असहयोग	asahayog
असहाय	asahaay
असहायता	asahaayata
असहिष्णु	asahishnu
असहिष्णुता	asahishnuta
असह्य	asahy
असाइन	asain
असाइनमेंट	asainament
असाक्षात्कथन	asaakshaatkathan
असाक्षिक	asaakshik
असाक्षी	asaakshee
असाधारण	asaadhaaran
असाधारणतः	asaadhaaranatah
असाधारणता	asaadhaaranata
असाध्य	asaadhy
असाध्यता	asaadhyata
असान	asaan
असामयिक	asaamayik
असामयिकता	asaamayikata
असामाजिक	asaamaajik
असामाजिकता	asaamaajikata
असामान्य	asaamaany
असामान्यता	asaamaanyata
असामान्यताएं	asaamaanyataen
असामियों	asaamiyon
असामी	asaamee
असावधान	asaavadhaan
असावधानतः	asaavadhaanatah
असावधानता	asaavadhaanata
असावधानियों	asaavadhaaniyon
असावधानी	asaavadhaanee
असावधानीपूर्ण	asaavadhaaneepoorn
असावधानीपूर्वक	asaavadhaaneepoorvak
असावधानीवश	asaavadhaaneevash
असावधान्	asaavadhaan
असाहसी	asaahasee
असाढ़ी	asaadhee
असि	asi
असिंचित	asinchit
असिक्रीड़ा	asikreeda
असित	asit
असिन	asin
असिस्टेंट	asistent
असिस्टैंटशिप	asistaintaship
असी	asee
असीम	aseem
असीमित	aseemit
असीमितता	aseemitata
असीरियाई	aseeriyaee
असुंदर	asundar
असुकुमार	asukumaar
असुख	asukh
असुखकर	asukhakar
असुखद	asukhad
असुखी	asukhee
असुधारित	asudhaarit
असुधार्य	asudhaary
असुन्दर	asundar
असुर	asur
असुरक्षा	asuraksha
असुरक्षित	asurakshit
असुरारि	asuraari
असुरों	asuron
असुविधा	asuvidha
असुविधाएँ	asuvidhaen
असुविधाओं	asuvidhaon
असुविधाजनक	asuvidhaajanak
असुविधापूर्ण	asuvidhaapoorn
असुस्थ	asusth
असूयक	asooyak
असेंबल	asembal
असेंबली	asembalee
असेम्बली	asembalee
असेवित	asevit
असेसमेंट	asesament
असैनिक	asainik
असैनिकीकृत	asainikeekrt
असैन्य	asainy
असोकी	asokee
असोख	asokh
असोसिएशन	asosieshan
असौर्स	asaurs
अस्त	ast
अस्तबल	astabal
अस्तर	astar
अस्तव्यत्स	astavyats
अस्तव्यस्त	astavyast
अस्ताना	astaana
अस्ति	asti
अस्तित्त्व	astittv
अस्तित्त्वहीन	astittvaheen
अस्तित्व	astitv
अस्तित्ववाद	astitvavaad
अस्तित्ववान	astitvavaan
अस्तित्वहीन	astitvaheen
अस्तित्वहीनता	astitvaheenata
अस्तित्वात्मक	astitvaatmak
अस्तित्वों	astitvon
अस्तुरा	astura
अस्तेय	astey
अस्त्र	astr
अस्त्रकार	astrakaar
अस्त्रजीवी	astrajeevee
अस्त्रधारी	astradhaaree
अस्त्रविराम	astraviraam
अस्त्रशाला	astrashaala
अस्त्रहीन	astraheen
अस्त्राण	astraan
अस्त्रियोचित	astriyochit
अस्त्रीकरण	astreekaran
अस्त्रों	astron
अस्थमा	asthama
अस्थाई	asthaee
अस्थाना	asthaana
अस्थानिक	asthaanik
अस्थायित्व	asthaayitv
अस्थायी	asthaayee
अस्थावर	asthaavar
अस्थि	asthi
अस्थिभंग	asthibhang
अस्थिमज्जा	asthimajja
अस्थिमात्र	asthimaatr
अस्थिमाली	asthimaalee
अस्थिमृदुता	asthimrduta
अस्थियाँ	asthiyaan
अस्थियों	asthiyon
अस्थिर	asthir
अस्थिरचित	asthirachit
अस्थिरचित्त	asthirachitt
अस्थिरता	asthirata
अस्थिरमति	asthiramati
अस्थिरवासी	asthiravaasee
अस्पंद	aspand
अस्पताल	aspataal
अस्पतालवास	aspataalavaas
अस्पतालों	aspataalon
अस्पष्ट	aspasht
अस्पष्टतः	aspashtatah
अस्पष्टता	aspashtata
अस्पष्टाक्षर	aspashtaakshar
अस्पष्टार्थ	aspashtaarth
अस्पष्टीकृत	aspashteekrt
अस्पृश्य	asprshy
अस्पृश्यता	asprshyata
अस्मत	asmat
अस्मिता	asmita
अस्र	asr
अस्वरूपी	asvaroopee
अस्वस्थ	asvasth
अस्वस्थता	asvasthata
अस्वाभाविक	asvaabhaavik
अस्वाभाविकता	asvaabhaavikata
अस्वास्थ्य	asvaasthy
अस्वास्थ्यकर	asvaasthyakar
अस्वीकरण	asveekaran
अस्वीकरणाधिकार	asveekaranaadhikaar
अस्वीकरणीय	asveekaraneey
अस्वीकार	asveekaar
अस्वीकार्य	asveekaary
अस्वीकार्यता	asveekaaryata
अस्वीकृत	asveekrt
अस्वीकृति	asveekrti
अस्वीक्रति	asveekrati
अस्सी	assee
अस्फ़ाल्ट	asfaalt
असफ़ल	asafal
असफ़लतापूर्वक	asafalataapoorvak
अहंकार	ahankaar
अहंकारपूर्ण	ahankaarapoorn
अहंकारपूर्वक	ahankaarapoorvak
अहंकारी	ahankaaree
अहंकारोन्माद	ahankaaronmaad
अहंकृति	ahankrti
अहंता	ahanta
अहंमन्य	ahammany
अहदी	ahadee
अहम	aham
अहमद	ahamad
अहमदनगर	ahamadanagar
अहमदपुर	ahamadapur
अहमदशाह	ahamadashaah
अहमदाबाद	ahamadaabaad
अहमदिया	ahamadiya
अहमदी	ahamadee
अहमवाद	ahamavaad
अहमियत	ahamiyat
अहम्	aham
अहमक़	ahamaq
अहरणीय	aharaneey
अहरह	aharah
अहर्ता	aharta
अहर्निश	aharnish
अहलकार	ahalakaar
अहलमद	ahalamad
अहलाद	ahalaad
अहलावत	ahalaavat
अहलुवालिया	ahaluvaaliya
अहलूवालिया	ahaloovaaliya
अहल्या	ahalya
अहसान	ahasaan
अहसास	ahasaas
अहसासों	ahasaason
अहस्कर	ahaskar
अहस्तांतरणीय	ahastaantaraneey
अहस्ताक्षरित	ahastaaksharit
अहस्तान्तरणीय	ahastaantaraneey
अहा	aha
अहाते	ahaate
अहानिकारकता	ahaanikaarakata
अहाब	ahaab
अहारना	ahaarana
अहि	ahi
अहिंदू	ahindoo
अहिंसक	ahinsak
अहिंसा	ahinsa
अहिंसात्मक	ahinsaatmak
अहिंसावादी	ahinsaavaadee
अहित	ahit
अहितेच्छा	ahitechchha
अहिनी	ahinee
अहिन्दी	ahindee
अहिल्या	ahilya
अहिल्याबाई	ahilyaabaee
अहीर	aheer
अहीरिन	aheerin
अहुरमज्द	ahuramajd
अहुरा	ahura
अहृदय	ahrday
अहृदयता	ahrdayata
अहेतुक	ahetuk
अहेड़	ahed
अहो	aho
अहोई	ahoee
अह्द	ahd
अक़्ल	aql
अक़्लमंद	aqlamand
अख़बारी	akhabaaree
अख़बारों	akhabaaron
अख़रोट	akharot
अख़्तियार	akhtiyaar
अज़	az
अज़बेस्टो	azabesto
अज़रबैजान	azarabaijaan
अज़हर	azahar
अज़हरुद्दीन	azaharuddeen
अज़ान	azaan
अज़ीज़	azeez
अज़ेलिया	azeliya
अड़	ad
अड़ंगा	adanga
अड़ंगेबाज़	adangebaaz
अड़चन	adachan
अड़चनों	adachanon
अड़तालीस	adataalees
अड़तीस	adatees
अड़ना	adana
अड़वार	adavaar
अड़वाल	adavaal
अड़सठ	adasath
अड़हुल	adahul
अड़ियल	adiyal
अड़ियलपन	adiyalapan
अड़े	ade
अढ़तिया	adhatiya
अढ़ाई	adhaee
अफ़गान	afagaan
अफ़गानिस्तान	afagaanistaan
अफ़गानीवासी	afagaaneevaasee
अफ़गानों	afagaanon
अफ़रीदी	afareedee
अफ़लातून	afalaatoon
अफ़वाही	afavaahee
अफ़वाहें	afavaahen
अफ़वाहों	afavaahon
अफ़संतीन	afasanteen
अफ़सरशाही	afasarashaahee
अफ़सराना	afasaraana
अफ़सरों	afasaron
अफ़साना	afasaana
अफ़साने	afasaane
अफ़सुरदा	afasurada
अफ़सोस	afasos
अफ़सोसनाक	afasosanaak
अफ़ीम	afeem
अफ़ीमची	afeemachee
अफ़्गानिस्तान	afgaanistaan
अफ़्यून	afyoon
अफ़्रिकैनी	afrikainee
अफ़्रीका	afreeka
अफ़्रीकाँस	afreekaans
अफ़्रीकान्स	afreekaans
अफ़्रीकी	afreekee
अफ़्रीदी	afreedee
अफ़्रो	afro
अफ़्ग़ानिस्तान	afgaanistaan
अफ़ग़ान	afagaan
अफ़ग़ानियों	afagaaniyon
अफ़ग़ानी	afagaanee
अफ़ग़ानों	afagaanon
अफ़ज़ल	afazal
आँक	aank
आँकना	aankana
आँका	aanka
आँकें	aanken
आँकड़ा	aankada
आँकड़ी	aankadee
आँकड़े	aankade
आँख	aankh
आँखे	aankhe
आँखें	aankhen
आँखो	aankho
आँखों	aankhon
आँगन	aangan
आँच	aanch
आँचल	aanchal
आँटी	aantee
आँत	aant
आँतें	aanten
आँतों	aanton
आँधी	aandhee
आँध्र	aandhr
आँवला	aanvala
आँसुओं	aansuon
आँसू	aansoo
आंकडा	aankada
आंकडे	aankade
आंकडों	aankadon
आंकना	aankana
आंकने	aankane
आंका	aanka
आंकिक	aankik
आंकी	aankee
आंकुस	aankus
आंकड़ा	aankada
आंकड़े	aankade
आंकड़ों	aankadon
आंख	aankh
आंखे	aankhe
आंखें	aankhen
आंखो	aankho
आंखों	aankhon
आंग	aang
आंगन	aangan
आंगिरस	aangiras
आंग्लप्रियता	aanglapriyata
आंग्लप्रेमी	aanglapremee
आंग्लरागी	aanglaraagee
आंच	aanch
आंचल	aanchal
आंचलिक	aanchalik
आंटी	aantee
आंत	aant
आंतक	aantak
आंतकवाद	aantakavaad
आंतकवादी	aantakavaadee
आंतरायिक	aantaraayik
आंतरिक	aantarik
आंतरिकता	aantarikata
आंतें	aanten
आंतों	aanton
आंत्र	aantr
आंत्रपुच्छकोप	aantrapuchchhakop
आंत्रशोथ	aantrashoth
आंत्रिक	aantrik
आंतड़ी	aantadee
आंदोलन	aandolan
आंदोलनकर्ता	aandolanakarta
आंदोलनकारियों	aandolanakaariyon
आंदोलनकारी	aandolanakaaree
आंदोलनों	aandolanon
आंदोलित	aandolit
आंद्रे	aandre
आंद्रेई	aandreee
आंधी	aandhee
आंध्र	aandhr
आंध्रप्रदेश	aandhrapradesh
आंनद	aannad
आंबेडकर	aambedakar
आंरभ	aanrabh
आंव	aanv
आंवला	aanvala
आंवले	aanvale
आंशका	aanshaka
आंशिक	aanshik
आंसुओं	aansuon
आंसू	aansoo
आंड़यल	aandayal
आइंदा	aainda
आइंस्टाइन	aainstain
आइंस्टीन	aainsteen
आइआरसी	aaiaarasee
आइए	aaie
आइएगा	aaiega
आइएसओ	aaieso
आइएसबी	aaiesabee
आइकन	aaikan
आइकमन	aaikaman
आइकॉन	aaikon
आइजक	aaijak
आइजैक	aaijaik
आइजोल	aaijol
आइजोल	aaijol
आइटम	aaitam
आइटम्स	aaitams
आइडल	aaidal
आइडिया	aaidiya
आइडेंटिटी	aaidentitee
आइना	aaina
आइनू	aainoo
आइने	aaine
आइन्स्टीन	aainsteen
आइपैड	aaipaid
आइपॉड	aaipod
आइपोमिया	aaipomiya
आइफोन	aaiphon
आइब्रो	aaibro
आइये	aaiye
आइरन	aairan
आइरिश	aairish
आइरिस	aairis
आइल	aail
आइलेट	aailet
आइलैंड	aailaind
आइलैंड्स	aailainds
आइवरी	aaivaree
आइवी	aaivee
आइसक्रीम	aaisakreem
आइसबर्ग	aaisabarg
आइसलैंड	aaisalaind
आइसलैंडिक	aaisalaindik
आइसलैण्ड	aaisalaind
आइसिंग	aaising
आइसीसी	aaiseesee
आइसो	aaiso
आइसोटोप	aaisotop
आइस्ड	aaisd
आइज़	aaiz
आइज़क	aaizak
आई	aaee
आईं	aaeen
आईआईएम	aaeeaeeem
आईआईटी	aaeeaeetee
आईआरएस	aaeeaares
आईआरसीटीसी	aaeeaaraseeteesee
आईईसी	aaeeeesee
आईएईए	aaeeeeee
आईएएस	aaeeees
आईएनए	aaeeene
आईएनएच	aaeeenech
आईएनसी	aaeeenasee
आईएमएफ	aaeeemeph
आईएसओ	aaeeeso
आईएसपी	aaeeesapee
आईएसपी	aaeeesapee
आईएसबीऍन	aaeeesabeeain
आईएसबीएन	aaeeesabeeen
आईओएल	aaeeoel
आईओसी	aaeeosee
आईगेट	aaeeget
आईटी	aaeetee
आईटीआईएल	aaeeteeaeeel
आईटीबीपी	aaeeteebeepee
आईटीयू	aaeeteeyoo
आईटीसी	aaeeteesee
आईट्यून्स	aaeetyoons
आईडी	aaeedee
आईडीबीआई	aaeedeebeeaee
आईडीसी	aaeedeesee
आईन	aaeen
आईना	aaeena
आईने	aaeene
आईपी	aaeepee
आईपीए	aaeepeee
आईपीएल	aaeepeeel
आईपीटीवी	aaeepeeteevee
आईपीसीसी	aaeepeeseesee
आईपैड	aaeepaid
आईपॉड	aaeepod
आईपोड	aaeepod
आईबी	aaeebee
आईबीएम	aaeebeeem
आईयूसीएन	aaeeyooseeen
आईये	aaeeye
आईलैंड	aaeelaind
आईवीएफ	aaeeveeeph
आईवीएफ़	aaeeveeef
आईवोर	aaeevor
आईसी	aaeesee
आईसीआईसीआई	aaeeseeaeeseeaee
आईसीटी	aaeeseetee
आईसीयू	aaeeseeyoo
आईसीसी	aaeeseesee
आईफ़ोन	aaeefon
आउंस	aauns
आउट	aaut
आउटडोर	aautador
आउटपुट	aautaput
आउटफिट	aautaphit
आउटफील्ड	aautapheeld
आउटबाउंड	aautabaund
आउटबॉक्स	aautaboks
आउटर	aautar
आउटरीच	aautareech
आउटलाइंग	aautalaing
आउटलुक	aautaluk
आउटलेट	aautalet
आउटसोर्स	aautasors
आउटसोर्सिंग	aautasorsing
आउटस्टैंडिंग	aautastainding
आऊँ	aaoon
आऊँगा	aaoonga
आऊँगी	aaoongee
आऊं	aaoon
आऊंगा	aaoonga
आऊट	aaoot
आएँ	aaen
आएँगी	aaengee
आएँगे	aaenge
आएं	aaen
आएंगी	aaengee
आएंगे	aaenge
आएंगें	aaengen
आएगा	aaega
आएगी	aaegee
आओ	aao
आओगे	aaoge
आक	aak
आकंठ	aakanth
आकंपित	aakampit
आकर	aakar
आकरी	aakaree
आकर्शक	aakarshak
आकर्षक	aakarshak
आकर्षकता	aakarshakata
आकर्षण	aakarshan
आकर्षणी	aakarshanee
आकर्षणों	aakarshanon
आकर्षित	aakarshit
आकलन	aakalan
आकलनकर्ता	aakalanakarta
आकलनों	aakalanon
आकलित	aakalit
आकलैंड	aakalaind
आकल्प	aakalp
आकस्मिक	aakasmik
आकस्मिकता	aakasmikata
आकस्मिकोद्भव	aakasmikodbhav
आका	aaka
आकांक्षा	aakaanksha
आकांक्षाओं	aakaankshaon
आकांक्षित	aakaankshit
आकांक्षी	aakaankshee
आकांशा	aakaansha
आकाओं	aakaon
आकार	aakaar
आकारक	aakaarak
आकारहीन	aakaaraheen
आकारहीनता	aakaaraheenata
आकारिक	aakaarik
आकारिकी	aakaarikee
आकारों	aakaaron
आकाल	aakaal
आकाश	aakaash
आकाशगंगा	aakaashaganga
आकाशगंगाओं	aakaashagangaon
आकाशज	aakaashaj
आकाशदीप	aakaashadeep
आकाशवाणी	aakaashavaanee
आकाशीय	aakaasheey
आकिन	aakin
आकिरकार	aakirakaar
आकीर्ण	aakeern
आकुल	aakul
आकुलता	aakulata
आकृति	aakrti
आकृतियाँ	aakrtiyaan
आकृतियां	aakrtiyaan
आकृतियों	aakrtiyon
आकृतिय़ा	aakrtiya
आकृष्ट	aakrsht
आके	aake
आक्रमण	aakraman
आक्रमणकारियों	aakramanakaariyon
आक्रमणकारी	aakramanakaaree
आक्रमणीय	aakramaneey
आक्रमणों	aakramanon
आक्रांत	aakraant
आक्रांता	aakraanta
आक्रान्त	aakraant
आक्रान्ता	aakraanta
आक्रामक	aakraamak
आक्रामकता	aakraamakata
आक्रोश	aakrosh
आक्रोशित	aakroshit
आक्षिप्त	aakshipt
आक्षीरी	aaksheeree
आक्षेप	aakshep
आक्षेपक	aakshepak
आक्षेपिक	aakshepik
आक्षेपों	aakshepon
आक्षेप्त	aakshept
आक्सफोर्ड	aaksaphord
आक्साइडों	aaksaidon
आक्सीजन	aakseejan
आकड़ों	aakadon
आखरी	aakharee
आखिर	aakhir
आखिरकार	aakhirakaar
आखिरी	aakhiree
आखि़र	aakhira
आखेट	aakhet
आखेटक	aakhetak
आखों	aakhon
आख्या	aakhya
आख्यान	aakhyaan
आख्यानिक	aakhyaanik
आख्यानों	aakhyaanon
आग	aag
आगंता	aaganta
आगंतुक	aagantuk
आगंतुकों	aagantukon
आगजनी	aagajanee
आगणक	aaganak
आगणन	aaganan
आगत	aagat
आगन्तुक	aagantuk
आगबबूला	aagababoola
आगम	aagam
आगमन	aagaman
आगमनवाद	aagamanavaad
आगमनवादी	aagamanavaadee
आगमनात्मक	aagamanaatmak
आगमों	aagamon
आगर	aagar
आगरकर	aagarakar
आगरा	aagara
आगरे	aagare
आगल	aagal
आगा	aaga
आगाज	aagaaj
आगामी	aagaamee
आगार	aagaar
आगाह	aagaah
आगाज़	aagaaz
आगिल	aagil
आगी	aagee
आगुआ	aagua
आगे	aage
आग्नीध्र	aagneedhr
आग्नेय	aagney
आग्नेयगिरि	aagneyagiri
आग्नेयास्त्र	aagneyaastr
आग्नेयास्त्रों	aagneyaastron
आग्नेयोद्गार	aagneyodgaar
आग्रवर्ती	aagravartee
आग्रह	aagrah
आग्रहपूर्ण	aagrahapoorn
आग्रही	aagrahee
आगज़नी	aagazanee
आघात	aaghaat
आघातक	aaghaatak
आघातों	aaghaaton
आघूर्ण	aaghoorn
आघोष	aaghosh
आचमन	aachaman
आचरण	aacharan
आचरणों	aacharanon
आचलता	aachalata
आचार	aachaar
आचारण	aachaaran
आचारिक	aachaarik
आचारी	aachaaree
आचार्य	aachaary
आचार्यजी	aachaaryajee
आचार्या	aachaarya
आचार्यानी	aachaaryaanee
आचार्यो	aachaaryo
आचार्यों	aachaaryon
आच्छद	aachchhad
आच्छा	aachchha
आच्छादन	aachchhaadan
आच्छादित	aachchhaadit
आच्छादी	aachchhaadee
आज	aaj
आजकल	aajakal
आजतक	aajatak
आजन्म	aajanm
आजम	aajam
आजमगढ	aajamagadh
आजमगढ़	aajamagadh
आजमपुर	aajamapur
आजमाइश	aajamaish
आजमाना	aajamaana
आजमाने	aajamaane
आजमाया	aajamaaya
आजमी	aajamee
आजा	aaja
आजाद	aajaad
आजादपुर	aajaadapur
आजादी	aajaadee
आजिज	aajij
आजीवन	aajeevan
आजीविका	aajeevika
आज्ञप्ति	aagyapti
आज्ञा	aagya
आज्ञाकारिता	aagyaakaarita
आज्ञाकारी	aagyaakaaree
आज्ञात्मक	aagyaatmak
आज्ञानुकूलता	aagyaanukoolata
आज्ञापक	aagyaapak
आज्ञापन	aagyaapan
आज्ञापरायणता	aagyaaparaayanata
आज्ञापालक	aagyaapaalak
आज्ञापालन	aagyaapaalan
आज्ञार्थ	aagyaarth
आज्ञार्थक	aagyaarthak
आटा	aata
आटे	aate
आटो	aato
आटोक्लेव	aatoklev
आठ	aath
आठवले	aathavale
आठवाँ	aathavaan
आठवां	aathavaan
आठवीं	aathaveen
आठवें	aathaven
आठैं	aathain
आठों	aathon
आड	aad
आडंबर	aadambar
आडंबरप्रिय	aadambarapriy
आडम्बर	aadambar
आडम्बरपूर्ण	aadambarapoorn
आडवाणी	aadavaanee
आडा	aada
आडिट	aadit
आडिटर	aaditar
आडियो	aadiyo
आणविक	aanavik
आण्विक	aanvik
आत	aat
आतंक	aatank
आतंककारी	aatankakaaree
आतंकवाद	aatankavaad
आतंकवादियों	aatankavaadiyon
आतंकवादी	aatankavaadee
आतंकित	aatankit
आतंकियों	aatankiyon
आतंकी	aatankee
आतंच	aatanch
आतंरिक	aatanrik
आततायी	aatataayee
आतशबाज़ी	aatashabaazee
आता	aata
आतिथ्य	aatithy
आतिश	aatish
आतिशबाजी	aatishabaajee
आतिशी	aatishee
आती	aatee
आतीं	aateen
आतुर	aatur
आतुरता	aaturata
आतुरताई	aaturataee
आतुरतापूर्वक	aaturataapoorvak
आते	aate
आत्म	aatm
आत्मकथा	aatmakatha
आत्मकथात्मक	aatmakathaatmak
आत्मकल्याण	aatmakalyaan
आत्मकेंद्रित	aatmakendrit
आत्मकेन्द्रीयता	aatmakendreeyata
आत्मगौरव	aatmagaurav
आत्मग्लानि	aatmaglaani
आत्मघात	aatmaghaat
आत्मघाती	aatmaghaatee
आत्मचिंतन	aatmachintan
आत्मज	aatmaj
आत्मजा	aatmaja
आत्मज्ञान	aatmagyaan
आत्मतत्त्व	aatmatattv
आत्मतत्त्वज्ञान	aatmatattvagyaan
आत्मतुष्ट	aatmatusht
आत्मतुष्टि	aatmatushti
आत्मतृप्ति	aatmatrpti
आत्मदाह	aatmadaah
आत्मनिरीक्षण	aatmanireekshan
आत्मनिर्णय	aatmanirnay
आत्मनिर्भर	aatmanirbhar
आत्मनिर्भरता	aatmanirbharata
आत्मनिषेध	aatmanishedh
आत्मनिषेधक	aatmanishedhak
आत्मनिषेधी	aatmanishedhee
आत्मनिष्ठ	aatmanishth
आत्मपीड़न	aatmapeedan
आत्मप्रदर्शनवादी	aatmapradarshanavaadee
आत्मप्रशंसा	aatmaprashansa
आत्मबल	aatmabal
आत्मबलिदानी	aatmabalidaanee
आत्मबोध	aatmabodh
आत्ममंथन	aatmamanthan
आत्मरक्षा	aatmaraksha
आत्मविकास	aatmavikaas
आत्मविज्ञापक	aatmavigyaapak
आत्मविज्ञापन	aatmavigyaapan
आत्मविनाशी	aatmavinaashee
आत्मविमोह	aatmavimoh
आत्मविश्लेषण	aatmavishleshan
आत्मविश्लेषी	aatmavishleshee
आत्मविश्वास	aatmavishvaas
आत्मविश्वासपूर्ण	aatmavishvaasapoorn
आत्मविश्वासहीन	aatmavishvaasaheen
आत्मविश्वासी	aatmavishvaasee
आत्मविषयक	aatmavishayak
आत्मविस्मृति	aatmavismrti
आत्मशक्ति	aatmashakti
आत्मसंतुष्ट	aatmasantusht
आत्मसंतुष्टि	aatmasantushti
आत्मसंतोष	aatmasantosh
आत्मसंदेह	aatmasandeh
आत्मसंयम	aatmasanyam
आत्मसंवरण	aatmasanvaran
आत्मसमर्पण	aatmasamarpan
आत्मसम्मान	aatmasammaan
आत्मसर्पण	aatmasarpan
आत्मसाक्षात्कार	aatmasaakshaatkaar
आत्मसात	aatmasaat
आत्मसात्	aatmasaat
आत्मसात्करण	aatmasaatkaran
आत्मसुझाव	aatmasujhaav
आत्मसुरक्षा	aatmasuraksha
आत्महत्या	aatmahatya
आत्महत्याएं	aatmahatyaen
आत्मा	aatma
आत्माएँ	aatmaen
आत्माएं	aatmaen
आत्माओं	aatmaon
आत्मानंद	aatmaanand
आत्मानुभव	aatmaanubhav
आत्मानुभूति	aatmaanubhooti
आत्मानुशासन	aatmaanushaasan
आत्माभिव्यंजना	aatmaabhivyanjana
आत्माराम	aatmaaraam
आत्मावलंबन	aatmaavalamban
आत्मावलंबी	aatmaavalambee
आत्मिक	aatmik
आत्मिकता	aatmikata
आत्मीय	aatmeey
आत्मीयता	aatmeeyata
आत्मोत्कर्ष	aatmotkarsh
आत्मोत्सर्ग	aatmotsarg
आत्मोन्नति	aatmonnati
आत्रेय	aatrey
आत्रेयी	aatreyee
आथि	aathi
आथी	aathee
आद	aad
आदत	aadat
आदतन	aadatan
आदतों	aadaton
आदम	aadam
आदमकद	aadamakad
आदमखोर	aadamakhor
आदमपुर	aadamapur
आदमियत	aadamiyat
आदमियो	aadamiyo
आदमियों	aadamiyon
आदमी	aadamee
आदमख़ोर	aadamakhor
आदर	aadar
आदरणिय	aadaraniy
आदरपूर्वक	aadarapoorvak
आदरसूचक	aadarasoochak
आदर्श	aadarsh
आदर्शतः	aadarshatah
आदर्शवाक्य	aadarshavaaky
आदर्शवाद	aadarshavaad
आदर्शवादियों	aadarshavaadiyon
आदर्शवादी	aadarshavaadee
आदर्शित	aadarshit
आदर्शीकरण	aadarsheekaran
आदर्शो	aadarsho
आदर्शों	aadarshon
आदर्शोक्ति	aadarshokti
आदर्शोन्मुख	aadarshonmukh
आदाता	aadaata
आदान	aadaan
आदाब	aadaab
आदि	aadi
आदिकाल	aadikaal
आदिकालीन	aadikaaleen
आदितः	aaditah
आदित्य	aadity
आदित्यसेन	aadityasen
आदिदेव	aadidev
आदिनाथ	aadinaath
आदिपर्व	aadiparv
आदिपुराण	aadipuraan
आदिपुरुष	aadipurush
आदिपुरूष	aadipuroosh
आदिबद्री	aadibadree
आदिम	aadim
आदिल	aadil
आदिलाबाद	aadilaabaad
आदिवर्णिक	aadivarnik
आदिवासियों	aadivaasiyon
आदिवासी	aadivaasee
आदिशक्ति	aadishakti
आदिष्ट	aadisht
आदी	aadee
आदीपन	aadeepan
आदेश	aadesh
आदेशपूर्ण	aadeshapoorn
आदेशात्मक	aadeshaatmak
आदेशानुसार	aadeshaanusaar
आदेशार्थ	aadeshaarth
आदेशित	aadeshit
आदेशों	aadeshon
आदोलन	aadolan
आद्यप्ररूपीय	aadyapraroopeey
आद्योगिक	aadyogik
आद्र	aadr
आद्रता	aadrata
आद्रा	aadra
आध	aadh
आधरित	aadharit
आधर्षण	aadharshan
आधा	aadha
आधान	aadhaan
आधार	aadhaar
आधारक	aadhaarak
आधारभूत	aadhaarabhoot
आधाररूप	aadhaararoop
आधारशिला	aadhaarashila
आधारहीन	aadhaaraheen
आधारिक	aadhaarik
आधारिका	aadhaarika
आधारित	aadhaarit
आधारी	aadhaaree
आधारों	aadhaaron
आधासीसी	aadhaaseesee
आधि	aadhi
आधिकारिक	aadhikaarik
आधिक्य	aadhiky
आधिदैविक	aadhidaivik
आधिपत्य	aadhipaty
आधिभौतिक	aadhibhautik
आधी	aadhee
आधीन	aadheen
आधुनिक	aadhunik
आधुनिकतम	aadhunikatam
आधुनिकता	aadhunikata
आधुनिकतावाद	aadhunikataavaad
आधुनिकतावादी	aadhunikataavaadee
आधुनिकरण	aadhunikaran
आधुनिकीकरण	aadhunikeekaran
आधुनिकोत्तरवादी	aadhunikottaravaadee
आधे	aadhe
आध्यात्म	aadhyaatm
आध्यात्मविद्या	aadhyaatmavidya
आध्यात्मिक	aadhyaatmik
आध्यात्मिकता	aadhyaatmikata
आनंद	aanand
आनंदकर	aanandakar
आनंदकारक	aanandakaarak
आनंदजी	aanandajee
आनंदजीवी	aanandajeevee
आनंददायक	aanandadaayak
आनंददिवस	aanandadivas
आनंदपुर	aanandapur
आनंदपूर्ण	aanandapoorn
आनंदपूर्वक	aanandapoorvak
आनंदप्रद	aanandaprad
आनंदमय	aanandamay
आनंदित	aanandit
आनंदी	aanandee
आनंदोत्सव	aanandotsav
आनंदोल्लास	aanandollaas
आनत	aanat
आनति	aanati
आननी	aananee
आनन्द	aanand
आनन्ददान	aanandadaan
आनन्दन	aanandan
आनन्दपुर	aanandapur
आनन्दमय	aanandamay
आनन्दित	aanandit
आनन्दी	aanandee
आनन्दोत्सव	aanandotsav
आनबान	aanabaan
आनरेरी	aanareree
आनर्त	aanart
आनलाइन	aanalain
आना	aana
आनाकानी	aanaakaanee
आनी	aanee
आनीत	aaneet
आनुपातिक	aanupaatik
आनुपूर्व	aanupoorv
आनुपूर्वी	aanupoorvee
आनुवंशिक	aanuvanshik
आनुवंशिकता	aanuvanshikata
आनुवंशिकी	aanuvanshikee
आनुवंशिकीविद्	aanuvanshikeevid
आनुवांशिक	aanuvaanshik
आनुवांशिकता	aanuvaanshikata
आनुवांशिकी	aanuvaanshikee
आनुवांशिकीविज्ञानी	aanuvaanshikeevigyaanee
आनुषंगिक	aanushangik
आनुषांगिक	aanushaangik
आने	aane
आनेवाला	aanevaala
आनेवाली	aanevaalee
आनेवाले	aanevaale
आनेवालों	aanevaalon
आन्तरिक	aantarik
आन्तर्राष्ट्रीयता	aantarraashtreeyata
आन्दोलक	aandolak
आन्दोलन	aandolan
आन्दोलनकारियों	aandolanakaariyon
आन्दोलनों	aandolanon
आन्द्रे	aandre
आन्ध्र	aandhr
आन्ध्रप्रदेश	aandhrapradesh
आन्नद	aannad
आन्नदोत्सव	aannadotsav
आप	aap
आपका	aapaka
आपकाजी	aapakaajee
आपकी	aapakee
आपके	aapake
आपको	aapako
आपकों	aapakon
आपजात्य	aapajaaty
आपटे	aapate
आपतिजनक	aapatijanak
आपत्ति	aapatti
आपत्तिकर्ता	aapattikarta
आपत्तिजनक	aapattijanak
आपत्तिपूर्ण	aapattipoorn
आपत्तियां	aapattiyaan
आपत्तियों	aapattiyon
आपत्तिहीन	aapattiheen
आपद	aapad
आपदा	aapada
आपदाएँ	aapadaen
आपदाओं	aapadaon
आपदाग्रस्त	aapadaagrast
आपना	aapana
आपने	aapane
आपन्न	aapann
आपबीती	aapabeetee
आपमें	aapamen
आपराधिक	aaparaadhik
आपरेटर	aaparetar
आपरेटिंग	aapareting
आपरेशन	aapareshan
आपरेशनों	aapareshanon
आपलोग	aapalog
आपस	aapas
आपसदारी	aapasadaaree
आपसी	aapasee
आपसे	aapase
आपही	aapahee
आपा	aapa
आपात	aapaat
आपातकाल	aapaatakaal
आपातकालीन	aapaatakaaleen
आपातस्थिति	aapaatasthiti
आपाधापी	aapaadhaapee
आपु	aapu
आपूरण	aapooran
आपूर्ति	aapoorti
आपूर्तिकर्ता	aapoortikarta
आपूर्तिकर्ताओं	aapoortikartaon
आपूर्तियाँ	aapoortiyaan
आपे	aape
आपेक्ष	aapeksh
आपेक्षिक	aapekshik
आपेक्षिकता	aapekshikata
आपेक्षिकीय	aapekshikeey
आपेक्षित	aapekshit
आपो	aapo
आप्टे	aapte
आप्त	aapt
आप्तता	aaptata
आप्ति	aapti
आप्तोक्ति	aaptokti
आप्रवास	aapravaas
आप्रवासियों	aapravaasiyon
आप्रवासी	aapravaasee
आप्लावित	aaplaavit
आप्लुत	aaplut
आफ	aaph
आफत	aaphat
आफताब	aaphataab
आफिस	aaphis
आफिसर	aaphisar
आफीसर	aapheesar
आफ्टर	aaphtar
आबंटन	aabantan
आबंटनों	aabantanon
आबंटित	aabantit
आबंटी	aabantee
आबकारी	aabakaaree
आबखोरा	aabakhora
आबद्ध	aabaddh
आबनूसी	aabanoosee
आबरू	aabaroo
आबहवा	aabahava
आबाद	aabaad
आबादकार	aabaadakaar
आबादानी	aabaadaanee
आबादियों	aabaadiyon
आबादी	aabaadee
आबी	aabee
आबू	aaboo
आबोहवा	aabohava
आभा	aabha
आभामंडल	aabhaamandal
आभार	aabhaar
आभारी	aabhaaree
आभाव	aabhaav
आभास	aabhaas
आभासी	aabhaasee
आभिजात्य	aabhijaaty
आभीर	aabheer
आभूषण	aabhooshan
आभूषणों	aabhooshanon
आभूषित	aabhooshit
आम	aam
आमंत्रण	aamantran
आमंत्रित	aamantrit
आमंत्रितअना	aamantritana
आमचुनाव	aamachunaav
आमतौर	aamataur
आमद	aamad
आमदनी	aamadanee
आमना	aamana
आमने	aamane
आमन्त्रण	aamantran
आमन्त्रित	aamantrit
आमरण	aamaran
आमलकी	aamalakee
आमला	aamala
आमलेट	aamalet
आमवात	aamavaat
आमवाती	aamavaatee
आमादा	aamaada
आमान	aamaan
आमार	aamaar
आमाल	aamaal
आमाशय	aamaashay
आमिर	aamir
आमिल	aamil
आमीन	aameen
आमुख	aamukh
आमूल	aamool
आमेर	aamer
आमों	aamon
आमोद	aamod
आमोन	aamon
आम्र	aamr
आम्रकुंज	aamrakunj
आम्रपाली	aamrapaalee
आय	aay
आयंगर	aayangar
आयकर	aayakar
आयडाहो	aayadaaho
आयड्रॉपर	aayadropar
आयत	aayat
आयतन	aayatan
आयताकार	aayataakaar
आयतुल्ला	aayatulla
आयतें	aayaten
आयतों	aayaton
आयद	aayad
आयन	aayan
आयनन	aayanan
आयनिक	aayanik
आयनित	aayanit
आयनीकरण	aayaneekaran
आयर	aayar
आयरन	aayaran
आयरलैंड	aayaralaind
आयरलैंडवासी	aayaralaindavaasee
आयरलैण्ड	aayaralaind
आयरलैण्डवासी	aayaralaindavaasee
आयरिश	aayarish
आयरी	aayaree
आयर्स	aayars
आयल	aayal
आयलर	aayalar
आयलैंड	aayalaind
आयशा	aayasha
आयस	aayas
आया	aaya
आयात	aayaat
आयातक	aayaatak
आयातकों	aayaatakon
आयातित	aayaatit
आयाम	aayaam
आयामी	aayaamee
आयामों	aayaamon
आयी	aayee
आयीं	aayeen
आयु	aayu
आयुक्त	aayukt
आयुक्तों	aayukton
आयुध	aayudh
आयुधों	aayudhon
आयुर्विज्ञान	aayurvigyaan
आयुर्वेद	aayurved
आयुर्वेदाचार्य	aayurvedaachaary
आयुर्वेदिक	aayurvedik
आयुवर्ग	aayuvarg
आयुष	aayush
आयुषी	aayushee
आयुष्मान	aayushmaan
आये	aaye
आयें	aayen
आयेंगे	aayenge
आयेंगें	aayengen
आयेगा	aayega
आयेगी	aayegee
आयो	aayo
आयोग	aayog
आयोगों	aayogon
आयोजक	aayojak
आयोजकों	aayojakon
आयोजन	aayojan
आयोजनों	aayojanon
आयोजिक	aayojik
आयोजित	aayojit
आयोटा	aayota
आयोडाइड	aayodaid
आयोडिन	aayodin
आयोडीन	aayodeen
आयोनिक	aayonik
आयोनियन	aayoniyan
आयोनी	aayonee
आयोवा	aayova
आर	aar
आरंगुटान	aarangutaan
आरंभ	aarambh
आरंभक	aarambhak
आरंभकर्ता	aarambhakarta
आरंभिक	aarambhik
आरआईबी	aaraeebee
आरईसी	aareesee
आरईसी	aareesee
आरएएफ	aareeph
आरएनए	aarene
आरएफसी	aarephasee
आरएमएस	aaremes
आरएमपी	aaremapee
आरके	aarake
आरक्षक	aarakshak
आरक्षण	aarakshan
आरक्षित	aarakshit
आरक्षी	aarakshee
आरजीबी	aarajeebee
आरजू	aarajoo
आरजे	aaraje
आरटीआई	aarateeaee
आरटीई	aarateeee
आरडी	aaradee
आरण्यक	aaranyak
आरतियों	aaratiyon
आरती	aaratee
आरन्गोटैंग	aarangotaing
आरपार	aarapaar
आरपी	aarapee
आरपीजी	aarapeejee
आरबीआई	aarabeeaee
आरबीएस	aarabeees
आरबीसी	aarabeesee
आरमीनियन	aarameeniyan
आरमेइक	aarameik
आरम्भ	aarambh
आरम्भिक	aarambhik
आरव	aarav
आरसी	aarasee
आरस्य	aarasy
आरा	aara
आराकस	aaraakas
आराधक	aaraadhak
आराधना	aaraadhana
आराधनापूर्ण	aaraadhanaapoorn
आराधनालय	aaraadhanaalay
आराध्य	aaraadhy
आराम	aaraam
आरामकरना	aaraamakarana
आरामकुर्सी	aaraamakursee
आरामगाह	aaraamagaah
आरामतलब	aaraamatalab
आरामतलबी	aaraamatalabee
आरामदाय	aaraamadaay
आरामदायक	aaraamadaayak
आरामदेह	aaraamadeh
आरिफ	aariph
आरिया	aariya
आरिफ़	aarif
आरी	aaree
आरुणि	aaruni
आरुल	aarul
आरुषि	aarushi
आरेख	aarekh
आरेखकार	aarekhakaar
आरेखण	aarekhan
आरेखीय	aarekheey
आरोग्य	aarogy
आरोग्यआश्रम	aarogyaashram
आरोग्यकारक	aarogyakaarak
आरोग्यजनक	aarogyajanak
आरोग्यता	aarogyata
आरोग्यप्रद	aarogyaprad
आरोग्यलाभ	aarogyalaabh
आरोग्यशास्र	aarogyashaasr
आरोचन	aarochan
आरोन	aaron
आरोप	aarop
आरोपक	aaropak
आरोपण	aaropan
आरोपणीय	aaropaneey
आरोपित	aaropit
आरोपियों	aaropiyon
आरोपी	aaropee
आरोपों	aaropon
आरोह	aaroh
आरोहक	aarohak
आरोहण	aarohan
आरोहमापक	aarohamaapak
आरोहित	aarohit
आरोही	aarohee
आर्क	aark
आर्कटिक	aarkatik
आर्कटिकसागर	aarkatikasaagar
आर्कबिशप	aarkabishap
आर्कषण	aarkashan
आर्काइव	aarkaiv
आर्किटेक्चर	aarkitekchar
आर्किटेक्ट	aarkitekt
आर्किड	aarkid
आर्किमिडिज़	aarkimidiz
आर्किमिडीज	aarkimideej
आर्कियन	aarkiyan
आर्किया	aarkiya
आर्केडिया	aarkediya
आर्केस्ट्र	aarkestr
आर्केस्ट्रा	aarkestra
आर्गन	aargan
आर्गेनाइजेशन	aargenaijeshan
आर्गेनिक	aargenik
आर्च	aarch
आर्चबिशप	aarchabishap
आर्ची	aarchee
आर्ट	aart
आर्टस	aartas
आर्टिकल	aartikal
आर्टिकल्स	aartikals
आर्टिफिशियल	aartiphishiyal
आर्टिलरी	aartilaree
आर्टिस्ट	aartist
आर्टिस्ट्स	aartists
आर्टेमिस	aartemis
आर्ट्स	aarts
आर्डर	aardar
आर्डिनेंस	aardinens
आर्त	aart
आर्तनाद	aartanaad
आर्तवजनक	aartavajanak
आर्थर	aarthar
आर्थराइटिस	aartharaitis
आर्थिक	aarthik
आर्थिकसहायता	aarthikasahaayata
आर्थिकिता	aarthikita
आर्थिकी	aarthikee
आर्थोपेडिक	aarthopedik
आर्थ्राइटिस	aarthraitis
आर्दश	aardash
आर्द्र	aardr
आर्द्रक	aardrak
आर्द्रकर	aardrakar
आर्द्रकारक	aardrakaarak
आर्द्रता	aardrata
आर्द्रतामापी	aardrataamaapee
आर्द्रतारहित	aardrataarahit
आर्द्रा	aardra
आर्द्रीकरण	aardreekaran
आर्नल्ड	aarnald
आर्पेजिओ	aarpejio
आर्म	aarm
आर्मस्ट्रांग	aarmastraang
आर्मी	aarmee
आर्मीनिया	aarmeeniya
आर्मीनियाई	aarmeeniyaee
आर्मेचर	aarmechar
आर्मेनियन	aarmeniyan
आर्मेनिया	aarmeniya
आर्मेनियाई	aarmeniyaee
आर्य	aary
आर्यन	aaryan
आर्यपुत्र	aaryaputr
आर्यभट	aaryabhat
आर्यभटीय	aaryabhateey
आर्यभट्ट	aaryabhatt
आर्यभाषाओं	aaryabhaashaon
आर्यसमाज	aaryasamaaj
आर्या	aarya
आर्यावर्त	aaryaavart
आर्यिका	aaryika
आर्यों	aaryon
आर्लिन्गटन	aarlingatan
आर्शिवाद	aarshivaad
आर्शीवाद	aarsheevaad
आर्सीन	aarseen
आर्सेनल	aarsenal
आर्सेनाइट	aarsenait
आर्सेनिक	aarsenik
आर्सेलर	aarselar
आरज़ू	aarazoo
आलंकारिक	aalankaarik
आलंब	aalamb
आलंबन	aalamban
आलंबी	aalambee
आलपिन	aalapin
आलपीन	aalapeen
आलप्पुष़ा	aalappushaa
आलमआरा	aalamaara
आलमगीर	aalamageer
आलमनगर	aalamanagar
आलमपुर	aalamapur
आलमारियों	aalamaariyon
आलमारी	aalamaaree
आलमी	aalamee
आलम्बन	aalamban
आलवार	aalavaar
आलस	aalas
आलसियों	aalasiyon
आलसी	aalasee
आलसीपन	aalaseepan
आलस्य	aalasy
आलस्यजनक	aalasyajanak
आलस्यपूर्ण	aalasyapoorn
आला	aala
आलाप	aalaap
आलापना	aalaapana
आलावा	aalaava
आलिंगन	aalingan
आलिंगनबद्ध	aalinganabaddh
आलिंगित	aalingit
आलिंद	aalind
आलिम	aalim
आलिया	aaliya
आलीशान	aaleeshaan
आलू	aaloo
आलूबुखारा	aaloobukhaara
आलेख	aalekh
आलेखक	aalekhak
आलेखन	aalekhan
आलेखीय	aalekheey
आलेखों	aalekhon
आलेप	aalep
आलोक	aalok
आलोकन	aalokan
आलोकित	aalokit
आलोचक	aalochak
आलोचकों	aalochakon
आलोचना	aalochana
आलोचनाएँ	aalochanaen
आलोचनाएं	aalochanaen
आलोचनाओं	aalochanaon
आलोचनात्मक	aalochanaatmak
आलोचनावादी	aalochanaavaadee
आलोचनीय	aalochaneey
आलोच्य	aalochy
आलोड़न	aalodan
आलोड़ना	aalodana
आलौकिक	aalaukik
आल्टो	aalto
आल्डर	aaldar
आल्पप्रदेशीय	aalpapradesheey
आल्पीय	aalpeey
आल्प्स	aalps
आल्हा	aalha
आव	aav
आवंटन	aavantan
आवंटनअ	aavantan
आवंटित	aavantit
आवक	aavak
आवक्ष	aavaksh
आवक्षमूर्ति	aavakshamoorti
आवत	aavat
आवधिक	aavadhik
आवधिकता	aavadhikata
आवनी	aavanee
आवभगत	aavabhagat
आवर	aavar
आवरक	aavarak
आवरण	aavaran
आवरणों	aavaranon
आवर्जन	aavarjan
आवर्जित	aavarjit
आवर्त	aavart
आवर्तक	aavartak
आवर्तन	aavartan
आवर्ती	aavartee
आवर्धक	aavardhak
आवर्धन	aavardhan
आवर्धित	aavardhit
आवर्स	aavars
आवलि	aavali
आवश्कता	aavashkata
आवश्यक	aavashyak
आवश्यकता	aavashyakata
आवश्यकताएँ	aavashyakataen
आवश्यकताएं	aavashyakataen
आवश्यकताओं	aavashyakataon
आवश्यकतानुसार	aavashyakataanusaar
आवश्यक्ता	aavashyakta
आवश्यता	aavashyata
आवसा	aavasa
आवा	aava
आवाँ	aavaan
आवां	aavaan
आवागमन	aavaagaman
आवाज	aavaaj
आवाजाही	aavaajaahee
आवाजें	aavaajen
आवाजों	aavaajon
आवाम	aavaam
आवारगी	aavaaragee
आवारा	aavaara
आवारागर्द	aavaaraagard
आवारागर्दी	aavaaraagardee
आवास	aavaas
आवासन	aavaasan
आवासी	aavaasee
आवासीय	aavaaseey
आवासों	aavaason
आवाहन	aavaahan
आवाह्न	aavaahn
आवाज़	aavaaz
आवाज़ों	aavaazon
आविर्भाव	aavirbhaav
आविर्भूत	aavirbhoot
आविष्करण	aavishkaran
आविष्कर्ता	aavishkarta
आविष्कर्त्ता	aavishkartta
आविष्कार	aavishkaar
आविष्कारक	aavishkaarak
आविष्कारशील	aavishkaarasheel
आविष्कारशीलता	aavishkaarasheelata
आविष्कारी	aavishkaaree
आविष्कारों	aavishkaaron
आविष्कृत	aavishkrt
आविष्ट	aavisht
आवृत	aavrt
आवृति	aavrti
आवृतियों	aavrtiyon
आवृत्तबीजी	aavrttabeejee
आवृत्ति	aavrtti
आवृत्तिदर्शी	aavrttidarshee
आवृत्तियाँ	aavrttiyaan
आवृत्तियां	aavrttiyaan
आवृत्तियों	aavrttiyon
आवृ्ति	aavrti
आवे	aave
आवें	aaven
आवेंगे	aavenge
आवेग	aaveg
आवेगपूर्ण	aavegapoorn
आवेगहीन	aavegaheen
आवेगिता	aavegita
आवेगी	aavegee
आवेगों	aavegon
आवेदक	aavedak
आवेदकों	aavedakon
आवेदन	aavedan
आवेदनपत्रों	aavedanapatron
आवेदनीय	aavedaneey
आवेदनों	aavedanon
आवेदित	aavedit
आवेश	aavesh
आवेशपूर्ण	aaveshapoorn
आवेशित	aaveshit
आवेशों	aaveshon
आवेष्टन	aaveshtan
आवेष्टित	aaveshtit
आव्यूह	aavyooh
आव्रजन	aavrajan
आव्हान	aavhaan
आश	aash
आशंकनीय	aashankaneey
आशंका	aashanka
आशंकाएँ	aashankaen
आशंकाएं	aashankaen
आशंकाओं	aashankaon
आशंकाजनक	aashankaajanak
आशंकाप्रद	aashankaaprad
आशंकावान	aashankaavaan
आशंकित	aashankit
आशंसन	aashansan
आशना	aashana
आशनाई	aashanaee
आशय	aashay
आशयों	aashayon
आशवासन	aashavaasan
आशा	aasha
आशाएं	aashaen
आशाओं	aashaon
आशाजनक	aashaajanak
आशातीत	aashaateet
आशान्वित	aashaanvit
आशापूर्णा	aashaapoorna
आशापूर्वक	aashaapoorvak
आशामय	aashaamay
आशायें	aashaayen
आशारानी	aashaaraanee
आशालता	aashaalata
आशावाद	aashaavaad
आशावादिता	aashaavaadita
आशावादी	aashaavaadee
आशावान	aashaavaan
आशाहीन	aashaaheen
आशिक	aashik
आशिकी	aashikee
आशिम	aashim
आशियाँ	aashiyaan
आशियाना	aashiyaana
आशियाने	aashiyaane
आशिर्वाद	aashirvaad
आशिष	aashish
आशिक़	aashiq
आशिक़ा	aashiqa
आशिक़ी	aashiqee
आशी	aashee
आशीर्वचन	aasheervachan
आशीर्वाद	aasheervaad
आशीर्वादात्मक	aasheervaadaatmak
आशीष	aasheesh
आशु	aashu
आशुग	aashug
आशुतोष	aashutosh
आशुप्रभावित	aashuprabhaavit
आशुरचना	aashurachana
आशुलिपि	aashulipi
आशुलिपिक	aashulipik
आशूरी	aashooree
आशोधन	aashodhan
आश्चर्य	aashchary
आश्चर्यकारी	aashcharyakaaree
आश्चर्यचकित	aashcharyachakit
आश्चर्यजनक	aashcharyajanak
आश्चर्यपूर्वक	aashcharyapoorvak
आश्चर्यलोक	aashcharyalok
आश्चर्यान्वित	aashcharyaanvit
आश्चर्यों	aashcharyon
आश्रम	aashram
आश्रमवासी	aashramavaasee
आश्रमों	aashramon
आश्रय	aashray
आश्रयदाता	aashrayadaata
आश्रयदाती	aashrayadaatee
आश्रयस्थल	aashrayasthal
आश्रयों	aashrayon
आश्रित	aashrit
आश्रितों	aashriton
आश्वस्त	aashvast
आश्वस्ति	aashvasti
आश्वासन	aashvaasan
आश्वासना	aashvaasana
आश्वासनीय	aashvaasaneey
आश्वासनों	aashvaasanon
आश्वासित	aashvaasit
आश्वासी	aashvaasee
आश्विन	aashvin
आषाढ	aashaadh
आषाढ़	aashaadh
आस	aas
आसंग	aasang
आसंजक	aasanjak
आसंजन	aasanjan
आसंजनशीलता	aasanjanasheelata
आसंजित	aasanjit
आसकत	aasakat
आसकती	aasakatee
आसक्त	aasakt
आसक्ति	aasakti
आसज्जा	aasajja
आसन	aasan
आसनसोल	aasanasol
आसनों	aasanon
आसन्दी	aasandee
आसन्न	aasann
आसन्नता	aasannata
आसपास	aasapaas
आसफ	aasaph
आसमाँ	aasamaan
आसमान	aasamaan
आसमानी	aasamaanee
आसमानों	aasamaanon
आसरा	aasara
आसरे	aasare
आसवक	aasavak
आसवन	aasavan
आसवनी	aasavanee
आसवित	aasavit
आसा	aasa
आसान	aasaan
आसानी	aasaanee
आसाम	aasaam
आसार	aasaar
आसाराम	aasaaraam
आसारामजी	aasaaraamajee
आसिफ	aasiph
आसियान	aasiyaan
आसियाना	aasiyaana
आसिफ़	aasif
आसीन	aaseen
आसीस	aasees
आसुत	aasut
आसुर	aasur
आसुरी	aasuree
आसू	aasoo
आसूचना	aasoochana
आसेधक	aasedhak
आस्क	aask
आस्कर	aaskar
आस्की	aaskee
आस्क्ति	aaskti
आस्टसीलस्कप	aastaseelaskap
आस्टिन	aastin
आस्ट्रिया	aastriya
आस्ट्रियाई	aastriyaee
आस्ट्रेलियन	aastreliyan
आस्ट्रेलिया	aastreliya
आस्ट्रेलियाई	aastreliyaee
आस्ति	aasti
आस्तिक	aastik
आस्तिकता	aastikata
आस्तिकवाद	aastikavaad
आस्तिकवादी	aastikavaadee
आस्तिक्य	aastiky
आस्तित्व	aastitv
आस्तियां	aastiyaan
आस्तियों	aastiyon
आस्तीन	aasteen
आस्तीनदार	aasteenadaar
आस्त्र	aastr
आस्थगित	aasthagit
आस्था	aastha
आस्थाएं	aasthaen
आस्थाओं	aasthaon
आस्थान	aasthaan
आस्थानी	aasthaanee
आस्थावान	aasthaavaan
आस्मान	aasmaan
आस्वाद	aasvaad
आस्वादन	aasvaadan
आस्वादनीय	aasvaadaneey
आस्वादित	aasvaadit
आस्वाद्य	aasvaady
आसफ़ुद्दौला	aasafuddaula
आहट	aahat
आहत	aahat
आहर	aahar
आहरण	aaharan
आहरित	aaharit
आहवान	aahavaan
आहा	aaha
आहार	aahaar
आहारों	aahaaron
आहिस्ता	aahista
आहिस्ते	aahiste
आहुति	aahuti
आहुतियाँ	aahutiyaan
आहूजा	aahooja
आहूत	aahoot
आहूति	aahooti
आहें	aahen
आह्लाद	aahlaad
आह्लादक	aahlaadak
आह्लादजनक	aahlaadajanak
आह्लादित	aahlaadit
आह्वान	aahvaan
आक़ा	aaqa
आख़री	aakharee
आख़िरकार	aakhirakaar
आग़ा	aaga
आज़म	aazam
आज़मगढ़	aazamagadh
आज़मा	aazama
आज़माइश	aazamaish
आज़माए	aazamae
आज़माना	aazamaana
आज़मियम	aazamiyam
आज़मी	aazamee
आज़र्बैजान	aazarbaijaan
आज़ादी	aazaadee
आड़	aad
आड़ना	aadana
आड़बंद	aadaband
आड़ा	aada
आड़ी	aadee
आड़े	aade
आढ़त	aadhat
आढ़तिया	aadhatiya
आफ़त	aafat
आफ़ताबगीर	aafataabageer
आफ़िस	aafis
आफ़्टर	aaftar
आफ़्टरशेव	aaftarashev
इंक	ink
इंकलाब	inkalaab
इंकार	inkaar
इंगलिश	ingalish
इंगलैंड	ingalaind
इंगलैण्ड	ingalaind
इंगित	ingit
इंगुर	ingur
इंग्लिश	inglish
इंग्लिस्तान	inglistaan
इंग्लिस्तानी	inglistaanee
इंग्लेंड	inglend
इंग्लैंड	inglaind
इंग्लैड	inglaid
इंग्लैण्ड	inglaind
इंच	inch
इंचार्ज	inchaarj
इंजन	injan
इंजनों	injanon
इंजिन	injin
इंजिनियर	injiniyar
इंजिनियरिंग	injiniyaring
इंजीनियर	injeeniyar
इंजीनियरिंग	injeeniyaring
इंजीनियरी	injeeniyaree
इंजीनियरों	injeeniyaron
इंजीनियर्स	injeeniyars
इंजील	injeel
इंजीलवाद	injeelavaad
इंजेक्शन	injekshan
इंजेक्षन	injekshan
इंटर	intar
इंटरएक्टिव	intarektiv
इंटरकांटिनेंटल	intarakaantinental
इंटरकॉम	intarakom
इंटरचेंज	intarachenj
इंटरटेंमेंट	intaratemment
इंटरटेनमेंट	intaratenament
इंटरनेट	intaranet
इंटरनेशनल	intaraneshanal
इंटरनैशनल	intaranaishanal
इंटरपोल	intarapol
इंटरप्राइज	intarapraij
इंटरप्रिटेशन	intarapriteshan
इंटरप्रेटर	intarapretar
इंटरफेरॉन	intarapheron
इंटरफेस	intaraphes
इंटरमीडिएट	intarameediet
इंटरलिंगुआ	intaralingua
इंटरवल	intaraval
इंटरव्यू	intaravyoo
इंटरसिटी	intarasitee
इंटरसेप्टर	intaraseptar
इंटरस्टेट	intarastet
इंटरेक्टिव	intarektiv
इंटरैक्टिव	intaraiktiv
इंटर्न	intarn
इंटर्नशिप	intarnaship
इंटरफ़ेस	intarafes
इंटीग्रल	inteegral
इंटीग्रेटेड	inteegreted
इंटीरियर	inteeriyar
इंटेरमेस्सो	interamesso
इंटेल	intel
इंटेलिजेंस	intelijens
इंटेलीजेंस	inteleejens
इंट्रानेट	intraanet
इंट्रामस्क्युलर	intraamaskyular
इंट्रोडक्शन	introdakshan
इंडस	indas
इंडस्ट्रियल	indastriyal
इंडस्ट्री	indastree
इंडस्ट्रीज	indastreej
इंडस्ट्रीज़	indastreez
इंडिक	indik
इंडिकस	indikas
इंडिका	indika
इंडिकॉम	indikom
इंडिगो	indigo
इंडिपेंडेंट	indipendent
इंडियंस	indiyans
इंडियन	indiyan
इंडियन्स	indiyans
इंडिया	indiya
इंडियाना	indiyaana
इंडियानापोलिस	indiyaanaapolis
इंडी	indee
इंडीज	indeej
इंडीज़	indeez
इंडेंट	indent
इंडेंटेशन	indenteshan
इंडेक्स	indeks
इंडोनिशया	indonishaya
इंडोनीशियन	indoneeshiyan
इंडोनेशिया	indoneshiya
इंडोनेशियाई	indoneshiyaee
इंडोर	indor
इंडोस्कोपिक	indoskopik
इंत	int
इंतकाम	intakaam
इंतकाल	intakaal
इंतजाम	intajaam
इंतजार	intajaar
इंतहा	intaha
इंतियाज़ी	intiyaazee
इंतिहा	intiha
इंतिहान	intihaan
इंतिख़ाब	intikhaab
इंतिज़ार	intizaar
इंतक़ाल	intaqaal
इंतज़ाम	intazaam
इंतज़ामों	intazaamon
इंतज़ार	intazaar
इंदर	indar
इंदरजीत	indarajeet
इंदराज	indaraaj
इंदिरा	indira
इंदिराजी	indiraajee
इंदौर	indaur
इंद्र	indr
इंद्रजाल	indrajaal
इंद्रजालिक	indrajaalik
इंद्रजीत	indrajeet
इंद्रधनुष	indradhanush
इंद्रधनुषी	indradhanushee
इंद्रप्रस्थ	indraprasth
इंद्रा	indra
इंद्राणी	indraanee
इंद्रावती	indraavatee
इंद्रिय	indriy
इंद्रियगत	indriyagat
इंद्रियगम्य	indriyagamy
इंद्रियगम्यता	indriyagamyata
इंद्रियग्राह्य	indriyagraahy
इंद्रियजन्य	indriyajany
इंद्रियदमनना	indriyadamanana
इंद्रियनिग्रह	indriyanigrah
इंद्रियनिग्रहकारी	indriyanigrahakaaree
इंद्रियां	indriyaan
इंद्रियार्थवादी	indriyaarthavaadee
इंद्रियासक्त	indriyaasakt
इंद्रियों	indriyon
इंद्री	indree
इंपीरियल	impeeriyal
इंप्रेशन	impreshan
इंफाल	imphaal
इंफ्रास्ट्रक्चर	imphraastrakchar
इंफ्लुएंजा	imphluenja
इंशाअल्लाह	inshaallaah
इंश्योरेंस	inshyorens
इंसपेक्टर	insapektar
इंसान	insaan
इंसानियत	insaaniyat
इंसानी	insaanee
इंसानों	insaanon
इंसाफ	insaaph
इंसाफ़	insaaf
इंसुलिन	insulin
इंस्टाल	instaal
इंस्टालेशन	instaaleshan
इंस्टिट्यूट	instityoot
इंस्टीच्यूट	insteechyoot
इंस्टीटयूट	insteetayoot
इंस्टीट्यूट	insteetyoot
इंस्टीट्यूशन	insteetyooshan
इंस्टीट्यूशनल	insteetyooshanal
इंस्टेंट	instent
इंस्टैंट	instaint
इंस्टॉल	instol
इंस्ट्रक्टर	instraktar
इंस्ट्रुमेंटेशन	instrumenteshan
इंस्ट्रुमेंट्स	instruments
इंस्पेक्टर	inspektar
इंक़लाब	inqalaab
इंज़माम	inzamaam
इंफ़ोसिस	imfosis
इंफ़्रारेड	imfraared
इओसिनोफिलिक	iosinophilik
इक	ik
इकजुठ	ikajuth
इकटठा	ikatatha
इकटठे	ikatathe
इकटा	ikata
इकट्ठा	ikattha
इकट्ठी	ikatthee
इकट्ठे	ikatthe
इकठ्ठा	ikaththa
इकतारा	ikataara
इकतालीस	ikataalees
इकतीस	ikatees
इकनॉमिक	ikanomik
इकन्नी	ikannee
इकबाल	ikabaal
इकबालिया	ikabaaliya
इकमुश्त	ikamusht
इकरंगा	ikaranga
इकराम	ikaraam
इकरार	ikaraar
इकरारनामा	ikaraaranaama
इकरारी	ikaraaree
इकलौता	ikalauta
इकलौती	ikalautee
इकलौते	ikalaute
इकसठ	ikasath
इकसिंगा	ikasinga
इकहरी	ikaharee
इकाइयाँ	ikaiyaan
इकाइयां	ikaiyaan
इकाइयों	ikaiyon
इकाई	ikaee
इकाईयां	ikaeeyaan
इकाईयों	ikaeeyon
इकानवे	ikaanave
इकॉनॉमिक	ikonomik
इकॉनोमिक	ikonomik
इकॉनोमिक्स	ikonomiks
इको	iko
इकोनामिक	ikonaamik
इकोनॉमिक	ikonomik
इकोनॉमिक्स	ikonomiks
इकोनॉमी	ikonomee
इकोनोमिक	ikonomik
इकोले	ikole
इकौना	ikauna
इक्का	ikka
इक्कीस	ikkees
इक्कीसवाँ	ikkeesavaan
इक्कीसवीं	ikkeesaveen
इक्ट्ठा	ikttha
इक्वाडोर	ikvaador
इक्विटी	ikvitee
इक्विपमेंट	ikvipament
इक्ष्वाकु	ikshvaaku
इख्तियार	ikhtiyaar
इगतपुरी	igatapuree
इगलास	igalaas
इगारह	igaarah
इगोर	igor
इग्निशन	ignishan
इग्नू	ignoo
इग्रेट	igret
इग्लैंड	iglaind
इच्छा	ichchha
इच्छाएँ	ichchhaen
इच्छाएं	ichchhaen
इच्छाओं	ichchhaon
इच्छाधारी	ichchhaadhaaree
इच्छानुरूप	ichchhaanuroop
इच्छानुसार	ichchhaanusaar
इच्छापूर्वक	ichchhaapoorvak
इच्छाशक्ति	ichchhaashakti
इच्छित	ichchhit
इच्छुक	ichchhuk
इज	ij
इजराइल	ijarail
इजराइली	ijarailee
इजरायल	ijaraayal
इजरायली	ijaraayalee
इजलास	ijalaas
इजहार	ijahaar
इजाजत	ijaajat
इजाद	ijaad
इजाफा	ijaapha
इजारा	ijaara
इजारेदार	ijaaredaar
इजारेदारी	ijaaredaaree
इजाज़त	ijaazat
इजिप्ट	ijipt
इज्जत	ijjat
इज्ज़त	ijzat
इट	it
इटली	italee
इटानगर	itaanagar
इटारसी	itaarasee
इटालियन	itaaliyan
इटावा	itaava
इटेलियन	iteliyan
इटैलिक	itailik
इटैलियन	itailiyan
इट्स	its
इठलाना	ithalaana
इडली	idalee
इडियट	idiyat
इडुक्की	idukkee
इण्टर	intar
इण्टरनेशनल	intaraneshanal
इण्टरमीडिएट	intarameediet
इण्डस्ट्रियल	indastriyal
इण्डिक	indik
इण्डिका	indika
इण्डियन	indiyan
इण्डिया	indiya
इण्डोनेशिया	indoneshiya
इण्डोनेशियाई	indoneshiyaee
इत	it
इतना	itana
इतनी	itanee
इतने	itane
इतनो	itano
इतमीनान	itameenaan
इतरलिंगी	itaralingee
इतरा	itara
इतरानेवाला	itaraanevaala
इतवार	itavaar
इताअत	itaat
इतालवी	itaalavee
इतावली	itaavalee
इति	iti
इतिश्री	itishree
इतिहास	itihaas
इतिहासकार	itihaasakaar
इतिहासकारों	itihaasakaaron
इतिहासज्ञ	itihaasagy
इतिहासपरक	itihaasaparak
इतिहासविद्	itihaasavid
इतिहासवेत्ता	itihaasavetta
इत्तफाक	ittaphaak
इत्तला	ittala
इत्ता	itta
इत्तिला	ittila
इत्तिफ़ाक़	ittifaaq
इत्तेफ़ाक	ittefaak
इत्तफ़ाक	ittafaak
इत्मीनान	itmeenaan
इत्यादि	ityaadi
इत्यादी	ityaadee
इत्र	itr
इत्रदान	itradaan
इत्रफ़रोश	itrafarosh
इत्रफ़रोशी	itrafaroshee
इत्सिंग	itsing
इथरनेट	itharanet
इथाकी	ithaakee
इथियोपिया	ithiyopiya
इथियोपियाई	ithiyopiyaee
इथेन	ithen
इथेनॉल	ithenol
इथोनोएट	ithonoet
इथोपिया	ithopiya
इदं	idan
इधर	idhar
इधार	idhaar
इन	in
इनकमिंग	inakaming
इनका	inaka
इनकार	inakaar
इनकी	inakee
इनके	inake
इनको	inako
इनकोडिंग	inakoding
इनक्यूबेटर	inakyoobetar
इनटू	inatoo
इनटेक	inatek
इनडोर	inador
इनपर	inapar
इनपुट	inaput
इनपुट्स	inaputs
इनपूट	inapoot
इनफ्लो	inaphlo
इनमे	iname
इनमें	inamen
इनर	inar
इनलाइन	inalain
इनलैंड	inalaind
इनवेंटरी	inaventaree
इनवॉयस	inavoyas
इनसाइक्लोपीडिया	inasaiklopeediya
इनसाइड	inasaid
इनसान	inasaan
इनसानियत	inasaaniyat
इनसानी	inasaanee
इनसानों	inasaanon
इनसे	inase
इनसेट	inaset
इनस्क्रिप्ट	inaskript
इनाम	inaam
इनामी	inaamee
इनायत	inaayat
इनायतपुर	inaayatapur
इनीयस	ineeyas
इनूइट	inooit
इनेमल	inemal
इनेलो	inelo
इनैमल	inaimal
इनोवेशन	inoveshan
इन्कलाब	inkalaab
इन्कार	inkaar
इन्क्यूबेटर	inkyoobetar
इन्च	inch
इन्जीनियरिंग	injeeniyaring
इन्टर	intar
इन्टरनेट	intaranet
इन्टरनेशनल	intaraneshanal
इन्टरफेस	intaraphes
इन्टरमीडिएट	intarameediet
इन्टरव्यू	intaravyoo
इन्टेल	intel
इन्डियन	indiyan
इन्डिया	indiya
इन्डेक्स	indeks
इन्डोनेशियाई	indoneshiyaee
इन्तजाम	intajaam
इन्तजार	intajaar
इन्तहा	intaha
इन्तिज़ार	intizaar
इन्तज़ार	intazaar
इन्दिरा	indira
इन्दीवर	indeevar
इन्दु	indu
इन्दौर	indaur
इन्द्र	indr
इन्द्रजाल	indrajaal
इन्द्रजीत	indrajeet
इन्द्रदेव	indradev
इन्द्रधनुष	indradhanush
इन्द्रपुरी	indrapuree
इन्द्रप्रस्थ	indraprasth
इन्द्रा	indra
इन्द्राणी	indraanee
इन्द्रावती	indraavatee
इन्द्रिय	indriy
इन्द्रियगम्य	indriyagamy
इन्द्रियनिग्रह	indriyanigrah
इन्द्रियबोध	indriyabodh
इन्द्रियाँ	indriyaan
इन्द्रियां	indriyaan
इन्द्रियातीत	indriyaateet
इन्द्रियों	indriyon
इन्द्रीय	indreey
इन्नोवेटर	innovetar
इन्फैंट्री	inphaintree
इन्फैन्ट्री	inphaintree
इन्फॉर्मेशन	inphormeshan
इन्फो	inpho
इन्फोकॉम	inphokom
इन्फोसिस	inphosis
इन्फ्रारेड	inphraared
इन्फ्रास्ट्रक्चर	inphraastrakchar
इन्फ्लुएंजा	inphluenja
इन्फ्लूएंजा	inphlooenja
इन्वर्टर	invartar
इन्वायरमेंटल	invaayaramental
इन्वार	invaar
इन्वेंटरी	inventaree
इन्वेस्टमेंट	investament
इन्वेस्टर	investar
इन्वेस्टिगेशन	investigeshan
इन्स	ins
इन्सपेक्टर	insapektar
इन्सान	insaan
इन्सानियत	insaaniyat
इन्सानी	insaanee
इन्साफ	insaaph
इन्साफ़	insaaf
इन्सुलिन	insulin
इन्सुलेटर	insuletar
इन्सेप्शन	insepshan
इन्स्क्रिप्ट	inskript
इन्स्टीट्यूट	insteetyoot
इन्स्पेक्टर	inspektar
इन्ही	inhee
इन्हीं	inheen
इन्हे	inhe
इन्हें	inhen
इन्हैं	inhain
इन्होंने	inhonne
इन्होने	inhone
इन्होनें	inhonen
इन्फ़्लुएन्ज़ा	influenza
इनफ़ारमेशन	inafaarameshan
इनफ़ेक्शन	inafekshan
इनफ़्लुएंज़ा	inafluenza
इप्टा	ipta
इफ	iph
इफरात	ipharaat
इफेक्ट	iphekt
इफेक्ट्स	iphekts
इफ्तिखार	iphtikhaar
इब	ib
इबलीस	ibalees
इबादत	ibaadat
इबारत	ibaarat
इबेरिया	iberiya
इब्तिदाई	ibtidaee
इब्ने	ibne
इब्रानी	ibraanee
इब्राहिम	ibraahim
इब्राहिमपुर	ibraahimapur
इब्राहीम	ibraaheem
इब्राहीमपुर	ibraaheemapur
इब्राहीमी	ibraaheemee
इब्रियों	ibriyon
इम	im
इमकान	imakaan
इमदाद	imadaad
इमदादी	imadaadee
इमरजेंसी	imarajensee
इमरती	imaratee
इमरसन	imarasan
इमरान	imaraan
इमरोज़	imaroz
इमर्जेंसी	imarjensee
इमर्सन	imarsan
इमर्सन	imarsan
इमली	imalee
इमल्शन	imalshan
इमादपुर	imaadapur
इमान	imaan
इमानदार	imaanadaar
इमानदारी	imaanadaaree
इमानुएल	imaanuel
इमाम	imaam
इमामगंज	imaamaganj
इमामबाड़ा	imaamabaada
इमामों	imaamon
इमारत	imaarat
इमारती	imaaratee
इमारते	imaarate
इमारतें	imaaraten
इमारतों	imaaraton
इमारात	imaaraat
इमि	imi
इमेज	imej
इमेजर	imejar
इमेजिंग	imejing
इमेल	imel
इमोटिकॉन	imotikon
इम्तहान	imtahaan
इम्तिहान	imtihaan
इम्पीरियल	impeeriyal
इम्पैक्ट	impaikt
इम्पॉसिबल	imposibal
इम्पोर्ट	import
इम्प्रूवमेंट	improovament
इम्प्रेशनिस्टिक	impreshanistik
इम्प्लांट	implaant
इम्फाल	imphaal
इम्यू	imyoo
इम्यून	imyoon
इम्यूनो	imyoono
इम्फ़ाल	imfaal
इयर	iyar
इयरफोन	iyaraphon
इयर्स	iyars
इया	iya
इरकबाज़	irakabaaz
इरफान	iraphaan
इरविंग	iraving
इरविन	iravin
इरशाद	irashaad
इरसी	irasee
इरा	ira
इराक	iraak
इराकी	iraakee
इरादतन	iraadatan
इरादा	iraada
इरादाना	iraadaana
इरादे	iraade
इरादों	iraadon
इरान	iraan
इरानी	iraanee
इराक़	iraaq
इराक़ी	iraaqee
इरिट्रिया	iritriya
इरिडानस	iridaanas
इरिडियम	iridiyam
इरित्रिया	iritriya
इरीडियम	ireediyam
इरीडेसी	ireedesee
इरीना	ireena
इरेक्शन	irekshan
इरेजर	irejar
इरेटा	ireta
इरोड	irod
इर्द	ird
इर्दगिर्द	irdagird
इर्विन	irvin
इरफ़ान	irafaan
इल	il
इलजाम	ilajaam
इलस्ट्रीयस	ilastreeyas
इलस्ट्रेटर	ilastretar
इलस्ट्रेटेड	ilastreted
इलहाम	ilahaam
इलाइची	ilaichee
इलाका	ilaaka
इलाकाई	ilaakaee
इलाके	ilaake
इलाकों	ilaakon
इलाज	ilaaj
इलाजों	ilaajon
इलाना	ilaana
इलायची	ilaayachee
इलावा	ilaava
इलास्टिक	ilaastik
इलास्टिकयुक्त	ilaastikayukt
इलास्टोमेर	ilaastomer
इलाहबाद	ilaahabaad
इलाहाबाद	ilaahaabaad
इलाहाबादी	ilaahaabaadee
इलाही	ilaahee
इलाक़े	ilaaqe
इलाक़ों	ilaaqon
इलाज़	ilaaz
इलिनॉय	ilinoy
इलिनोइस	ilinois
इलियट	iliyat
इलियाना	iliyaana
इलियास	iliyaas
इली	ilee
इलीयुम	ileeyum
इलेक्ट्रान	ilektraan
इलेक्ट्रानिक	ilektraanik
इलेक्ट्रानिक्स	ilektraaniks
इलेक्ट्रानों	ilektraanon
इलेक्ट्रिक	ilektrik
इलेक्ट्रिकल	ilektrikal
इलेक्ट्रिकल्स	ilektrikals
इलेक्ट्रीशियन	ilektreeshiyan
इलेक्ट्रॉन	ilektron
इलेक्ट्रॉनिक	ilektronik
इलेक्ट्रॉनिकी	ilektronikee
इलेक्ट्रॉनिक्स	ilektroniks
इलेक्ट्रॉनों	ilektronon
इलेक्ट्रोकार्डियोग्राम	ilektrokaardiyograam
इलेक्ट्रोटाइप	ilektrotaip
इलेक्ट्रोड	ilektrod
इलेक्ट्रोन	ilektron
इलेक्ट्रोनिक	ilektronik
इलेक्ट्रोनिक्स	ilektroniks
इलेक्ट्रोलाइट	ilektrolait
इलेक्स	ileks
इलेवन	ilevan
इलैक्टिव	ilaiktiv
इलैक्ट्रानिक	ilaiktraanik
इलैक्ट्रानिक्स	ilaiktraaniks
इलैक्ट्रिक	ilaiktrik
इलैक्ट्रॉन	ilaiktron
इलैक्ट्रॉनिक	ilaiktronik
इलैक्ट्रॉनिक्स	ilaiktroniks
इलैक्ट्रो	ilaiktro
इल्जाम	iljaam
इल्तिजा	iltija
इल्तुतमिश	iltutamish
इल्म	ilm
इल्मी	ilmee
इल्मेनाइट	ilmenait
इल्लियों	illiyon
इल्ली	illee
इल्हाम	ilhaam
इल्ज़ाम	ilzaam
इलज़ाम	ilazaam
इवनिंग	ivaning
इवा	iva
इवाते	ivaate
इवान	ivaan
इवानोविच	ivaanovich
इविल	ivil
इवेंट	ivent
इवेंट्स	ivents
इवोल्यूशन	ivolyooshan
इश	ish
इशरत	isharat
इशाक	ishaak
इशान	ishaan
इशारा	ishaara
इशारे	ishaare
इशारों	ishaaron
इशिका	ishika
इशिमुरा	ishimura
इशू	ishoo
इश्क	ishk
इश्कबाज	ishkabaaj
इश्कबाज़	ishkabaaz
इश्कबाज़ी	ishkabaazee
इश्किया	ishkiya
इश्तहार	ishtahaar
इश्तहारबाज़ी	ishtahaarabaazee
इश्तियाक	ishtiyaak
इश्तिहार	ishtihaar
इश्तीफा	ishteepha
इश्वर	ishvar
इश्वरेच्छाधीन	ishvarechchhaadheen
इश्क़	ishq
इश्क़बाज़	ishqabaaz
इष्ट	isht
इष्टकर	ishtakar
इष्टतम	ishtatam
इष्टदेव	ishtadev
इस	is
इसका	isaka
इसकी	isakee
इसकेबाद	isakebaad
इसको	isako
इसतरह	isatarah
इसने	isane
इसपर	isapar
इसबगोल	isabagol
इसमे	isame
इसमें	isamen
इसराइल	isarail
इसराइलियों	isarailiyon
इसराइली	isarailee
इसराईल	isaraeel
इसरायल	isaraayal
इसरार	isaraar
इसरो	isaro
इसलाम	isalaam
इसलामी	isalaamee
इसलाह	isalaah
इसलिए	isalie
इसलिये	isaliye
इसवी	isavee
इससे	isase
इसहाक	isahaak
इसा	isa
इसाई	isaee
इसाक	isaak
इसाबेल	isaabel
इसाबेला	isaabela
इसी	isee
इसीलिए	iseelie
इसीलिये	iseeliye
इसीलिये	iseeliye
इसे	ise
इस्करियोती	iskariyotee
इस्की	iskee
इस्कॉन	iskon
इस्ट	ist
इस्टर्न	istarn
इस्टेट	istet
इस्तगासा	istagaasa
इस्तमरारी	istamaraaree
इस्तमाल	istamaal
इस्तरी	istaree
इस्तांबुल	istaambul
इस्तिंजा	istinja
इस्तीफा	isteepha
इस्तीफे	isteephe
इस्तीफ़ा	isteefa
इस्तेमाल	istemaal
इस्तेमाली	istemaalee
इस्त्री	istree
इस्पात	ispaat
इस्पाती	ispaatee
इस्माइल	ismail
इस्माइलपुर	ismailapur
इस्माईल	ismaeel
इस्राइल	israil
इस्राइली	israilee
इस्राएल	israel
इस्ला	isla
इस्लाम	islaam
इस्लामपुर	islaamapur
इस्लामवादी	islaamavaadee
इस्लामाबाद	islaamaabaad
इस्लामिक	islaamik
इस्लामिया	islaamiya
इस्लामी	islaamee
इस्लामीकरण	islaameekaran
इस्फ़हान	isfahaan
इहतीओलोगिस्ट	ihateeologist
इहलोक	ihalok
इहाँ	ihaan
इहिं	ihin
इक़बाल	iqabaal
इक़रार	iqaraar
इक़रारनामा	iqaraaranaama
इक़रारी	iqaraaree
इख़लाक़ी	ikhalaaqee
इज़	iz
इज़राइल	izarail
इज़राइली	izarailee
इज़रायल	izaraayal
इज़रायली	izaraayalee
इज़र्ड	izard
इज़ाज़त	izaazat
इज़ाफ़ा	izaafa
इज़ी	izee
इज़ोटेर्म	izoterm
इज़्ज़त	izzat
इज़्ज़तदार	izzatadaar
इड़ा	ida
इफ़ेक्ट्स	ifekts
इफ़्तिख़ार	iftikhaar
इफ़्तेख़ार	iftekhaar
ईं	een
ईंट	eent
ईंटें	eenten
ईंटों	eenton
ईंधन	eendhan
ईंधनों	eendhanon
ईआईए	eeaeee
ईआर	eeaar
ईआरपी	eeaarapee
ईए	eee
ईएनटी	eeenatee
ईएमआई	eeemaee
ईएमएस	eeemes
ईएमयू	eeemayoo
ईएसए	eeese
ईएसपी	eeesapee
ईओण	eeon
ईकाइयों	eekaiyon
ईकाई	eekaee
ईक्विटी	eekvitee
ईक्षण	eekshan
ईख	eekh
ईगल	eegal
ईजल	eejal
ईजाद	eejaad
ईजियन	eejiyan
ईट	eet
ईटं	eetan
ईटहरी	eetaharee
ईटा	eeta
ईटानगर	eetaanagar
ईटिंग	eeting
ईटीवी	eeteevee
ईटें	eeten
ईटों	eeton
ईडन	eedan
ईडा	eeda
ईथर	eethar
ईथरनेट	eetharanet
ईद	eed
ईदगाह	eedagaah
ईदिपस	eedipas
ईद्भास	eedbhaas
ईद्भॉसबी	eedbhosabee
ईधंन	eedhann
ईधन	eedhan
ईन	een
ईनाम	eenaam
ईन्सेस्त	eensest
ईपिसल	eepisal
ईप्सा	eepsa
ईबुक	eebuk
ईबे	eebe
ईबोला	eebola
ईमान	eemaan
ईमानदार	eemaanadaar
ईमानदारी	eemaanadaaree
ईमारत	eemaarat
ईमेल	eemel
ईय	eey
ईयर	eeyar
ईयर्स	eeyars
ईराक	eeraak
ईराकी	eeraakee
ईरान	eeraan
ईरानियों	eeraaniyon
ईरानी	eeraanee
ईरी	eeree
ईरोड	eerod
ईर्ष्य	eershy
ईर्ष्यहीनता	eershyaheenata
ईर्ष्या	eershya
ईर्ष्यापूर्ण	eershyaapoorn
ईर्ष्यापूर्वक	eershyaapoorvak
ईर्ष्यालु	eershyaalu
ईर्ष्यालुस्ट्रि	eershyaalustri
ईर्ष्याहीनतः	eershyaaheenatah
ईरफ़ोन	eerafon
ईलम	eelam
ईला	eela
ईलाज	eelaaj
ईलिंग	eeling
ईवा	eeva
ईवान	eevaan
ईश	eesh
ईशता	eeshata
ईशनिंदा	eeshaninda
ईशा	eesha
ईशान	eeshaan
ईशानी	eeshaanee
ईशारा	eeshaara
ईशिता	eeshita
ईशित्व	eeshitv
ईशु	eeshu
ईश्वर	eeshvar
ईश्वरत्व	eeshvaratv
ईश्वरवाद	eeshvaravaad
ईश्वरवादी	eeshvaravaadee
ईश्वरी	eeshvaree
ईश्वरीय	eeshvareey
ईषना	eeshana
ईषा	eesha
ईष्ट	eesht
ईष्र्या	eeshrya
ईसप	eesap
ईसवीं	eesaveen
ईसा	eesa
ईसाइयत	eesaiyat
ईसाइयों	eesaiyon
ईसाई	eesaee
ईसाईयत	eesaeeyat
ईसाईयों	eesaeeyon
ईसापुर	eesaapur
ईसापूर्व	eesaapoorv
ईसामसीह	eesaamaseeh
ईसियम	eesiyam
ईसिस	eesis
ईसी	eesee
ईसीई	eeseeee
ईसीएम	eeseeem
ईसीजी	eeseejee
ईसुरी	eesuree
ईस्ट	eest
ईस्टर	eestar
ईस्टर्न	eestarn
ईस्टवुड	eestavud
ईस्माइलपुर	eesmailapur
ईस्वी	eesvee
ईहा	eeha
ईहामृग	eehaamrg
ईॉ	eeo
ईज़ेड	eezed
उँगलियाँ	ungaliyaan
उँगलियों	ungaliyon
उँगली	ungalee
उँचा	uncha
उँचाई	unchaee
उंगलियां	ungaliyaan
उंगलियों	ungaliyon
उंगली	ungalee
उंचा	uncha
उंचाई	unchaee
उंची	unchee
उंचे	unche
उंडेल	undel
उइग़ुर	uigur
उई	uee
उईघुर	ueeghur
उऋण	urn
उकता	ukata
उकताना	ukataana
उकलाना	ukalaana
उकसवाना	ukasavaana
उकसा	ukasa
उकसाई	ukasaee
उकसाकर	ukasaakar
उकसाना	ukasaana
उकसाने	ukasaane
उकसानेवाला	ukasaanevaala
उकसाया	ukasaaya
उकसावा	ukasaava
उकसावे	ukasaave
उकसाहट	ukasaahat
उकेरक	ukerak
उकेरना	ukerana
उकेरा	ukera
उकेरी	ukeree
उकेरे	ukere
उकेलना	ukelana
उक्त	ukt
उक्ति	ukti
उक्तियाँ	uktiyaan
उक्तियों	uktiyon
उक्रेनी	ukrenee
उकड़ू	ukadoo
उकड़ूं	ukadoon
उखटना	ukhatana
उखली	ukhalee
उखाड़	ukhaad
उखाड़ना	ukhaadana
उखाड़ने	ukhaadane
उखेड़	ukhed
उखेड़ना	ukhedana
उखड़	ukhad
उखड़ना	ukhadana
उखड़े	ukhade
उग	ug
उगता	ugata
उगती	ugatee
उगते	ugate
उगना	ugana
उगने	ugane
उगल	ugal
उगलता	ugalata
उगलना	ugalana
उगलने	ugalane
उगलवाना	ugalavaana
उगला	ugala
उगलिया	ugaliya
उगा	uga
उगाई	ugaee
उगाए	ugae
उगाते	ugaate
उगाना	ugaana
उगाने	ugaane
उगाया	ugaaya
उगायी	ugaayee
उगाये	ugaaye
उगालदान	ugaaladaan
उगाहना	ugaahana
उगाहने	ugaahane
उगाही	ugaahee
उगे	uge
उग्र	ugr
उग्रता	ugrata
उग्रतापूर्ण	ugrataapoorn
उग्रतापूर्वक	ugrataapoorvak
उग्रतारा	ugrataara
उग्रपंथियों	ugrapanthiyon
उग्रवाद	ugravaad
उग्रवादियों	ugravaadiyon
उग्रवादी	ugravaadee
उग्रशेखरा	ugrashekhara
उग्रसेन	ugrasen
उग्रसेन	ugrasen
उग्रायुध	ugraayudh
उघारा	ughaara
उघाड़ा	ughaada
उघड़ना	ughadana
उचकना	uchakana
उचका	uchaka
उचकाना	uchakaana
उचक्का	uchakka
उचटाना	uchataana
उचाटना	uchaatana
उचित	uchit
उच्च	uchch
उच्चकोटि	uchchakoti
उच्चकोटी	uchchakotee
उच्चतम	uchchatam
उच्चतर	uchchatar
उच्चता	uchchata
उच्चत्व	uchchatv
उच्चन्यायालय	uchchanyaayaalay
उच्चरित	uchcharit
उच्चवर्ग	uchchavarg
उच्चवर्गीय	uchchavargeey
उच्चशिक्षा	uchchashiksha
उच्चस्तरीय	uchchastareey
उच्चस्थली	uchchasthalee
उच्चस्थानीय	uchchasthaaneey
उच्चाटन	uchchaatan
उच्चाधिकारी	uchchaadhikaaree
उच्चायुक्त	uchchaayukt
उच्चायोग	uchchaayog
उच्चारण	uchchaaran
उच्चारणीय	uchchaaraneey
उच्चारित	uchchaarit
उच्चार्यमाण	uchchaaryamaan
उच्छल	uchchhal
उच्छानुरूप	uchchhaanuroop
उच्छिष्ट	uchchhisht
उच्छृंखल	uchchhrnkhal
उच्छृंखलता	uchchhrnkhalata
उच्छेद	uchchhed
उच्छेदन	uchchhedan
उच्छ्वसन	uchchhvasan
उच्छ्वास	uchchhvaas
उछंग	uchhang
उछल	uchhal
उछलकर	uchhalakar
उछलकूद	uchhalakood
उछलकूद	uchhalakood
उछलता	uchhalata
उछलते	uchhalate
उछलना	uchhalana
उछलने	uchhalane
उछला	uchhala
उछलाना	uchhalaana
उछले	uchhale
उछाल	uchhaal
उछालदार	uchhaaladaar
उछालना	uchhaalana
उछालने	uchhaalane
उछाला	uchhaala
उछाले	uchhaale
उछाह	uchhaah
उजबेकिस्तान	ujabekistaan
उजरत	ujarat
उजला	ujala
उजली	ujalee
उजले	ujale
उजागर	ujaagar
उजाड	ujaad
उजान	ujaan
उजालना	ujaalana
उजाला	ujaala
उजाले	ujaale
उजास	ujaas
उजाड़	ujaad
उजाड़ना	ujaadana
उजाड़ने	ujaadane
उजियार	ujiyaar
उजियारपुर	ujiyaarapur
उजियारा	ujiyaara
उजूबा	ujooba
उज्जयिनी	ujjayinee
उज्जवल	ujjaval
उज्जवलता	ujjavalata
उज्जैन	ujjain
उज्जैनी	ujjainee
उज्ज्वल	ujjval
उज्ज्वलता	ujjvalata
उज्ज्वलता	ujjvalata
उज्ज्वला	ujjvala
उज्बेकिस्तान	ujbekistaan
उज्रदार	ujradaar
उज्वल	ujval
उजड़	ujad
उजड़वाना	ujadavaana
उजड़ा	ujada
उजड़ापन	ujadaapan
उजड़े	ujade
उझकना	ujhakana
उटपटांग	utapataang
उठ	uth
उठँगना	uthangana
उठँगाना	uthangaana
उठंगाना	uthangaana
उठकर	uthakar
उठता	uthata
उठती	uthatee
उठते	uthate
उठना	uthana
उठने	uthane
उठवाना	uthavaana
उठा	utha
उठाइए	uthaie
उठाई	uthaee
उठाईगिरी	uthaeegiree
उठाऊ	uthaoo
उठाए	uthae
उठाएं	uthaen
उठाएगा	uthaega
उठाओ	uthao
उठाकर	uthaakar
उठाता	uthaata
उठाती	uthaatee
उठाते	uthaate
उठान	uthaan
उठाना	uthaana
उठानी	uthaanee
उठाने	uthaane
उठापटक	uthaapatak
उठाया	uthaaya
उठायी	uthaayee
उठाये	uthaaye
उठायें	uthaayen
उठाव	uthaav
उठावनी	uthaavanee
उठी	uthee
उठे	uthe
उठें	uthen
उठेंगे	uthenge
उठेगा	uthega
उठो	utho
उठौनी	uthaunee
उड	ud
उडनी	udanee
उडा	uda
उडान	udaan
उडाने	udaane
उडा़न	udana
उडियारी	udiyaaree
उडीसा	udeesa
उडी़सा	udeesa
उडुपी	udupee
उड्डयन	uddayan
उण्डुक	unduk
उत	ut
उतना	utana
उतनी	utanee
उतने	utane
उतपन्न	utapann
उतम	utam
उतर	utar
उतरकर	utarakar
उतरता	utarata
उतरती	utaratee
उतरते	utarate
उतरन	utaran
उतरना	utarana
उतरने	utarane
उतरवाकर	utaravaakar
उतरवाना	utaravaana
उतरवाया	utaravaaya
उतरा	utara
उतराँव	utaraanv
उतराई	utaraee
उतराना	utaraana
उतरी	utaree
उतरे	utare
उतरें	utaren
उतरेंगे	utarenge
उतरेगी	utaregee
उतसर्ग	utasarg
उतार	utaar
उतारकर	utaarakar
उतारती	utaaratee
उतारते	utaarate
उतारना	utaarana
उतारने	utaarane
उतारा	utaara
उतारी	utaaree
उतारू	utaaroo
उतारे	utaare
उतारेगा	utaarega
उतावल	utaaval
उतावला	utaavala
उतावलापन	utaavalaapan
उतावली	utaavalee
उतावलीपूर्ण	utaavaleepoorn
उतीर्ण	uteern
उतीर्णांक	uteernaank
उतृण	utrn
उतेजक	utejak
उतेजना	utejana
उतेजित	utejit
उत्	ut
उत्कंठा	utkantha
उत्कंठित	utkanthit
उत्कट	utkat
उत्कर्ष	utkarsh
उत्कर्षक	utkarshak
उत्कर्षण	utkarshan
उत्कल	utkal
उत्कलित	utkalit
उत्कीर्ण	utkeern
उत्कीर्णन	utkeernan
उत्कृष	utkrsh
उत्कृष्ट	utkrsht
उत्कृष्टता	utkrshtata
उत्कृष्ठ	utkrshth
उत्कृष्ठता	utkrshthata
उत्कृ्ष्ट	utkrsht
उत्क्रम	utkram
उत्क्रमण	utkraman
उत्क्रमणीय	utkramaneey
उत्क्रांति	utkraanti
उत्क्रामी	utkraamee
उत्क्रोश	utkrosh
उत्क्षिप्त	utkshipt
उत्क्षेप	utkshep
उत्खनक	utkhanak
उत्खनन	utkhanan
उत्खनित	utkhanit
उत्तकों	uttakon
उत्तपन्न	uttapann
उत्तम	uttam
उत्तमता	uttamata
उत्तर	uttar
उत्तरकथा	uttarakatha
उत्तरकाण्ड	uttarakaand
उत्तरकाल	uttarakaal
उत्तरकालीनता	uttarakaaleenata
उत्तरकाशी	uttarakaashee
उत्तरजीविता	uttarajeevita
उत्तरजीवी	uttarajeevee
उत्तरदाता	uttaradaata
उत्तरदाताओं	uttaradaataon
उत्तरदान	uttaradaan
उत्तरदायित्व	uttaradaayitv
उत्तरदायित्वपुर्ण	uttaradaayitvapurn
उत्तरदायित्वों	uttaradaayitvon
उत्तरदायी	uttaradaayee
उत्तरदिशा	uttaradisha
उत्तरदेशी	uttaradeshee
उत्तरपश्चिम	uttarapashchim
उत्तरपश्चिमोन्मुख	uttarapashchimonmukh
उत्तरपूर्व	uttarapoorv
उत्तरपूर्वी	uttarapoorvee
उत्तरप्रदेश	uttarapradesh
उत्तरवर्तन	uttaravartan
उत्तरवर्ती	uttaravartee
उत्तरा	uttara
उत्तराँचल	uttaraanchal
उत्तरांचल	uttaraanchal
उत्तराखंड	uttaraakhand
उत्तराखण्ड	uttaraakhand
उत्तराधिकार	uttaraadhikaar
उत्तराधिकारिणी	uttaraadhikaarinee
उत्तराधिकारियों	uttaraadhikaariyon
उत्तराधिकारी	uttaraadhikaaree
उत्तरापथ	uttaraapath
उत्तरापेक्षी	uttaraapekshee
उत्तरायण	uttaraayan
उत्तरायणी	uttaraayanee
उत्तरार्द्ध	uttaraarddh
उत्तरार्ध	uttaraardh
उत्तरावस्था	uttaraavastha
उत्तरासंग	uttaraasang
उत्तरी	uttaree
उत्तरीअमेरिका	uttareeamerika
उत्तरीय	uttareey
उत्तरों	uttaron
उत्तरोतर	uttarotar
उत्तरोत्तर	uttarottar
उत्तरोत्तरत्वरित	uttarottaratvarit
उत्तल	uttal
उत्तलता	uttalata
उत्ताल	uttaal
उत्तीर्ण	utteern
उत्तुंग	uttung
उत्तुंगताभीति	uttungataabheeti
उत्तेजक	uttejak
उत्तेजकता	uttejakata
उत्तेजनशील	uttejanasheel
उत्तेजनशीलता	uttejanasheelata
उत्तेजना	uttejana
उत्तेजनाओ	uttejanao
उत्तेजनाओं	uttejanaon
उत्तेजनापूर्ण	uttejanaapoorn
उत्तेजनापूर्वक	uttejanaapoorvak
उत्तेजनामय	uttejanaamay
उत्तेजनाहीन	uttejanaaheen
उत्तेजनीय	uttejaneey
उत्तेजित	uttejit
उत्तोलक	uttolak
उत्तोलन	uttolan
उत्तोलनसाधन	uttolanasaadhan
उत्थंभ	utthambh
उत्थान	utthaan
उत्थापक	utthaapak
उत्थापन	utthaapan
उत्थापित	utthaapit
उत्पति	utpati
उत्पत्ति	utpatti
उत्पत्तिकार	utpattikaar
उत्पत्तिमूलक	utpattimoolak
उत्पत्तिस्थान	utpattisthaan
उत्पन्न	utpann
उत्पन्ना	utpanna
उत्परिवर्तजन	utparivartajan
उत्परिवर्तन	utparivartan
उत्परिवर्तनों	utparivartanon
उत्परिवर्ती	utparivartee
उत्पल	utpal
उत्पाटित	utpaatit
उत्पात	utpaat
उत्पाती	utpaatee
उत्पाद	utpaad
उत्पादक	utpaadak
उत्पादकता	utpaadakata
उत्पादकों	utpaadakon
उत्पादन	utpaadan
उत्पादनकर्ता	utpaadanakarta
उत्पादनों	utpaadanon
उत्पादित	utpaadit
उत्पादिता	utpaadita
उत्पादों	utpaadon
उत्पाद्य	utpaady
उत्पीडन	utpeedan
उत्पीड़क	utpeedak
उत्पीड़कता	utpeedakata
उत्पीड़न	utpeedan
उत्पीड़ित	utpeedit
उत्प्रवण	utpravan
उत्प्रवास	utpravaas
उत्प्रवासन	utpravaasan
उत्प्रेक्षा	utpreksha
उत्प्रेरक	utprerak
उत्प्रेरकों	utprerakon
उत्प्रेरण	utpreran
उत्प्रेरित	utprerit
उत्प्लव	utplav
उत्प्लावक	utplaavak
उत्प्लावकता	utplaavakata
उत्प्लावन	utplaavan
उत्फुल्लता	utphullata
उत्स	uts
उत्संग	utsang
उत्संगित	utsangit
उत्संस्करण	utsanskaran
उत्सरण	utsaran
उत्सर्ग	utsarg
उत्सर्गी	utsargee
उत्सर्जक	utsarjak
उत्सर्जन	utsarjan
उत्सर्जनीय	utsarjaneey
उत्सर्जित	utsarjit
उत्सर्जी	utsarjee
उत्सर्पी	utsarpee
उत्सव	utsav
उत्सवी	utsavee
उत्सवों	utsavon
उत्सागनि	utsaagani
उत्सादन	utsaadan
उत्साह	utsaah
उत्साहजनक	utsaahajanak
उत्साहपूर्ण	utsaahapoorn
उत्साहपूर्वक	utsaahapoorvak
उत्साहभंग	utsaahabhang
उत्साहयुक्त	utsaahayukt
उत्साहवर्धक	utsaahavardhak
उत्साहवर्धन	utsaahavardhan
उत्साहशील	utsaahasheel
उत्साहहीन	utsaahaheen
उत्साहित	utsaahit
उत्साही	utsaahee
उत्सुक	utsuk
उत्सुकता	utsukata
उत्सुकतापूर्ण	utsukataapoorn
उत्सुकतावश	utsukataavash
उत्सेध	utsedh
उथल	uthal
उथलपुथल	uthalaputhal
उथला	uthala
उथली	uthalee
उथले	uthale
उद	ud
उदंड	udand
उदंतिका	udantika
उदगम	udagam
उदगार	udagaar
उदग्र	udagr
उदग्रता	udagrata
उदघाटन	udaghaatan
उदजन	udajan
उदबोधन	udabodhan
उदभव	udabhav
उदभेदन	udabhedan
उदय	uday
उदयगिरि	udayagiri
उदयन	udayan
उदयपुर	udayapur
उदयपुरी	udayapuree
उदयरामपुर	udayaraamapur
उदयसिंह	udayasinh
उदयाचल	udayaachal
उदर	udar
उदरगर्त	udaragart
उदरशूल	udarashool
उदरसंधान	udarasandhaan
उदरहीन	udaraheen
उदरीय	udareey
उदवायी	udavaayee
उदश्रु	udashru
उदहारण	udahaaran
उदात्त	udaatt
उदात्तता	udaattata
उदान	udaan
उदार	udaar
उदारचरित	udaaracharit
उदारता	udaarata
उदारतापूर्ण	udaarataapoorn
उदारतापूर्वक	udaarataapoorvak
उदारतावाद	udaarataavaad
उदारतावादी	udaarataavaadee
उदारपंथी	udaarapanthee
उदारमना	udaaramana
उदारवाद	udaaravaad
उदारवादियों	udaaravaadiyon
उदारवादी	udaaravaadee
उदारहण	udaarahan
उदारीकरण	udaareekaran
उदास	udaas
उदासी	udaasee
उदासीन	udaaseen
उदासीनता	udaaseenata
उदासीनतापूर्वक	udaaseenataapoorvak
उदासीनीकरण	udaaseeneekaran
उदाहरण	udaaharan
उदाहरणतः	udaaharanatah
उदाहरणस्वरूप	udaaharanasvaroop
उदाहरणात्मक	udaaharanaatmak
उदाहरणार्थ	udaaharanaarth
उदाहरणों	udaaharanon
उदिक	udik
उदित	udit
उदीयमान	udeeyamaan
उदुंबर	udumbar
उदेश्य	udeshy
उद्	ud
उद्कीर्ण	udkeern
उद्गम	udgam
उद्गाता	udgaata
उद्गार	udgaar
उद्गारों	udgaaron
उद्ग्रहण	udgrahan
उद्ग्रहित	udgrahit
उद्घर्षण	udgharshan
उद्घाटन	udghaatan
उद्घाटनात्मक	udghaatanaatmak
उद्घाटित	udghaatit
उद्घोष	udghosh
उद्घोषक	udghoshak
उद्घोषणा	udghoshana
उद्घोषित	udghoshit
उद्दंड	uddand
उद्दंडता	uddandata
उद्दंडतापूर्ण	uddandataapoorn
उद्दर्शन	uddarshan
उद्दाम	uddaam
उद्दीपक	uddeepak
उद्दीपन	uddeepan
उद्दीप्त	uddeept
उद्देश	uddesh
उद्देशिका	uddeshika
उद्देश्य	uddeshy
उद्देश्यपूर्ण	uddeshyapoorn
उद्देश्यवाद	uddeshyavaad
उद्देश्यवादी	uddeshyavaadee
उद्देश्यहीन	uddeshyaheen
उद्देश्यहीनता	uddeshyaheenata
उद्देश्यों	uddeshyon
उद्धत	uddhat
उद्धतता	uddhatata
उद्धरण	uddharan
उद्धरणचिह्न	uddharanachihn
उद्धरणिका	uddharanika
उद्धरणीय	uddharaneey
उद्धरणों	uddharanon
उद्धव	uddhav
उद्धार	uddhaar
उद्धारक	uddhaarak
उद्धारकर्ता	uddhaarakarta
उद्धृत	uddhrt
उद्धेश्य	uddheshy
उद्बंधित	udbandhit
उद्बोधन	udbodhan
उद्भव	udbhav
उद्भवन	udbhavan
उद्भावन	udbhaavan
उद्भावना	udbhaavana
उद्भूत	udbhoot
उद्भूति	udbhooti
उद्भेद	udbhed
उद्भेदन	udbhedan
उद्भ्रम	udbhram
उद्यत	udyat
उद्यम	udyam
उद्यमशीलता	udyamasheelata
उद्यमिता	udyamita
उद्यमियों	udyamiyon
उद्यमी	udyamee
उद्यमों	udyamon
उद्यान	udyaan
उद्यानकृषक	udyaanakrshak
उद्यानकृषि	udyaanakrshi
उद्यानस्थल	udyaanasthal
उद्यानिकी	udyaanikee
उद्यानों	udyaanon
उद्योग	udyog
उद्योगतंत्र	udyogatantr
उद्योगतंत्रवादी	udyogatantravaadee
उद्योगपति	udyogapati
उद्योगपतियों	udyogapatiyon
उद्योगवाद	udyogavaad
उद्योगव्यापी	udyogavyaapee
उद्योगशाला	udyogashaala
उद्योगिता	udyogita
उद्योगों	udyogon
उद्वह	udvah
उद्वहन	udvahan
उद्विग्न	udvign
उद्विग्नतः	udvignatah
उद्विग्नतापूर्वक	udvignataapoorvak
उद्वेग	udveg
उद्वेगकर	udvegakar
उद्वेगकारी	udvegakaaree
उद्वेगजनक	udvegajanak
उद्वेलन	udvelan
उद्वेलित	udvelit
उधम	udham
उधमपुर	udhamapur
उधमसिंह	udhamasinh
उधमसिंहनगर	udhamasinhanagar
उधमी	udhamee
उधर	udhar
उधार	udhaar
उधारकर्ता	udhaarakarta
उधारकर्ताओं	udhaarakartaon
उधारदाता	udhaaradaata
उधारदाताओं	udhaaradaataon
उधारना	udhaarana
उधारी	udhaaree
उधेड़ना	udhedana
उधेड़बुन	udhedabun
उधड़न	udhadan
उधड़ना	udhadana
उन	un
उनक	unak
उनका	unaka
उनकि	unaki
उनकी	unakee
उनके	unake
उनको	unako
उनकों	unakon
उनतीस	unatees
उनने	unane
उनपर	unapar
उनमे	uname
उनमें	unamen
उनलोगों	unalogon
उनसठ	unasath
उनसे	unase
उनहे	unahe
उनहोंने	unahonne
उना	una
उनासी	unaasee
उनींद	uneend
उनींदा	uneenda
उनींदापन	uneendaapan
उनींदी	uneendee
उन्नत	unnat
उन्नतांश	unnataansh
उन्नति	unnati
उन्नतिशील	unnatisheel
उन्नतिशीलता	unnatisheelata
उन्नतोदर	unnatodar
उन्नमनी	unnamanee
उन्नयन	unnayan
उन्नाव	unnaav
उन्निद्र	unnidr
उन्नी	unnee
उन्नीकृष्णन	unneekrshnan
उन्नीत	unneet
उन्नीस	unnees
उन्नीसवाँ	unneesavaan
उन्नीसवां	unneesavaan
उन्नीसवी	unneesavee
उन्नीसवीं	unneesaveen
उन्मंडल	unmandal
उन्मत	unmat
उन्मत्त	unmatt
उन्मत्तता	unmattata
उन्मत्तालय	unmattaalay
उन्माद	unmaad
उन्मादपूर्ण	unmaadapoorn
उन्मादी	unmaadee
उन्मार्गी	unmaargee
उन्मुक्त	unmukt
उन्मुक्तता	unmuktata
उन्मुख	unmukh
उन्मुखता	unmukhata
उन्मुखीकरण	unmukheekaran
उन्मूलक	unmoolak
उन्मूलन	unmoolan
उन्मूलनवाद	unmoolanavaad
उन्मूलनवादी	unmoolanavaadee
उन्मूलनीय	unmoolaneey
उन्मोचन	unmochan
उन्ह	unh
उन्ही	unhee
उन्हीं	unheen
उन्हे	unhe
उन्हें	unhen
उन्हैं	unhain
उन्हों	unhon
उन्होंने	unhonne
उन्होंनें	unhonnen
उन्होने	unhone
उन्होनें	unhonen
उप	up
उपअपराध	upaparaadh
उपकंठ	upakanth
उपकक्ष	upakaksh
उपकथा	upakatha
उपकथानक	upakathaanak
उपकप्तान	upakaptaan
उपकर	upakar
उपकरण	upakaran
उपकरणो	upakarano
उपकरणों	upakaranon
उपकला	upakala
उपकल्प	upakalp
उपकल्पन	upakalpan
उपकल्पना	upakalpana
उपकल्पित	upakalpit
उपकार	upakaar
उपकारी	upakaaree
उपकुल	upakul
उपकुलपति	upakulapati
उपकृत	upakrt
उपकृषक	upakrshak
उपकेंद्र	upakendr
उपकेन्द्रों	upakendron
उपकेश	upakesh
उपक्रम	upakram
उपक्रमण	upakraman
उपक्रमणिका	upakramanika
उपक्रमों	upakramon
उपक्रामी	upakraamee
उपक्षय	upakshay
उपक्षार	upakshaar
उपखंड	upakhand
उपखण्ड	upakhand
उपखाड़ी	upakhaadee
उपख्यान	upakhyaan
उपगण	upagan
उपगामी	upagaamee
उपगीत	upageet
उपगुप्त	upagupt
उपग्रह	upagrah
उपग्रहीय	upagraheey
उपग्रहों	upagrahon
उपग्राम	upagraam
उपचय	upachay
उपचयाधार	upachayaadhaar
उपचर्म	upacharm
उपचार	upachaar
उपचारात्मक	upachaaraatmak
उपचारिका	upachaarika
उपचारित	upachaarit
उपचारी	upachaaree
उपचारों	upachaaron
उपचित	upachit
उपचित्र	upachitr
उपचुनाव	upachunaav
उपज	upaj
उपजता	upajata
उपजना	upajana
उपजा	upaja
उपजाऊ	upajaoo
उपजाए	upajae
उपजात	upajaat
उपजाति	upajaati
उपजातियाँ	upajaatiyaan
उपजातियों	upajaatiyon
उपजाने	upajaane
उपजाया	upajaaya
उपजिला	upajila
उपजी	upajee
उपजीवन	upajeevan
उपजे	upaje
उपज्ञा	upagya
उपज्ञाता	upagyaata
उपठेका	upatheka
उपठेकेदार	upathekedaar
उपतंत्र	upatantr
उपदान	upadaan
उपदेश	upadesh
उपदेशक	upadeshak
उपदेशात्मक	upadeshaatmak
उपदेशों	upadeshon
उपदेश्य	upadeshy
उपद्रवकारिता	upadravakaarita
उपद्रवकारी	upadravakaaree
उपद्रवपूर्ण	upadravapoorn
उपद्रविता	upadravita
उपद्रवी	upadravee
उपद्रवों	upadravon
उपधारा	upadhaara
उपधृति	upadhrti
उपनगर	upanagar
उपनगरवासी	upanagaravaasee
उपनगरीय	upanagareey
उपनगरों	upanagaron
उपनदियाँ	upanadiyaan
उपनयन	upanayan
उपनाम	upanaam
उपनामों	upanaamon
उपनाह	upanaah
उपनिदेशक	upanideshak
उपनिधाता	upanidhaata
उपनियम	upaniyam
उपनिरीक्षक	upanireekshak
उपनिर्वाचन	upanirvaachan
उपनिवेश	upanivesh
उपनिवेशक	upaniveshak
उपनिवेशवाद	upaniveshavaad
उपनिवेशवादियों	upaniveshavaadiyon
उपनिवेशी	upaniveshee
उपनिवेशीकरण	upanivesheekaran
उपनिवेशीय	upanivesheey
उपनिवेशों	upaniveshon
उपनिषद	upanishad
उपनिषदो	upanishado
उपनिषदों	upanishadon
उपनिषद्	upanishad
उपनेता	upaneta
उपनेत्र	upanetr
उपनेमका	upanemaka
उपन्यास	upanyaas
उपन्यासकार	upanyaasakaar
उपन्यासकारों	upanyaasakaaron
उपन्यासिका	upanyaasika
उपन्यासों	upanyaason
उपपट्टा	upapatta
उपपट्टेदारी	upapattedaaree
उपपद	upapad
उपपरिवार	upaparivaar
उपपादक	upapaadak
उपपादन	upapaadan
उपपाद्य	upapaady
उपपुर	upapur
उपपृष्ठ	upaprshth
उपप्रकार	upaprakaar
उपप्रजाति	upaprajaati
उपप्रधानमंत्री	upapradhaanamantree
उपप्रमुख	upapramukh
उपप्रमेय	upapramey
उपबंध	upabandh
उपबंधक	upabandhak
उपबंधित	upabandhit
उपबंधों	upabandhon
उपबन्धित	upabandhit
उपबर्हण	upabarhan
उपबोली	upabolee
उपभवन	upabhavan
उपभाग	upabhaag
उपभाषा	upabhaasha
उपभाषाएँ	upabhaashaen
उपभाषाओं	upabhaashaon
उपभुक्त	upabhukt
उपभेद	upabhed
उपभेदों	upabhedon
उपभोक्ता	upabhokta
उपभोक्ताओं	upabhoktaon
उपभोक्तावाद	upabhoktaavaad
उपभोक्तावादी	upabhoktaavaadee
उपभोग	upabhog
उपभोगता	upabhogata
उपभोजित	upabhojit
उपभोज्य	upabhojy
उपमंडल	upamandal
उपमंत्री	upamantree
उपमण्डल	upamandal
उपमहाद्वीप	upamahaadveep
उपमहाद्वीपीय	upamahaadveepeey
उपमहानिदेशक	upamahaanideshak
उपमा	upama
उपमाओं	upamaon
उपमान	upamaan
उपमुख्यमंत्री	upamukhyamantree
उपमेय	upamey
उपयंत्र	upayantr
उपयाजक	upayaajak
उपयुक्त	upayukt
उपयुक्तता	upayuktata
उपयोक्ता	upayokta
उपयोक्ताओं	upayoktaon
उपयोग	upayog
उपयोगकर्ता	upayogakarta
उपयोगकर्ताओं	upayogakartaon
उपयोगिता	upayogita
उपयोगिताओं	upayogitaon
उपयोगितावाद	upayogitaavaad
उपयोगितावादी	upayogitaavaadee
उपयोगी	upayogee
उपयोगीकरण	upayogeekaran
उपयोगों	upayogon
उपयोजना	upayojana
उपय्योगी	upayyogee
उपर	upar
उपरति	uparati
उपरना	uparana
उपरला	uparala
उपरवार	uparavaar
उपराजदूत	uparaajadoot
उपराजप	uparaajap
उपराजा	uparaaja
उपराज्यपाल	uparaajyapaal
उपरान्त	uparaant
उपराष्ट्रपति	uparaashtrapati
उपराष्ट्रपतित्व	uparaashtrapatitv
उपरि	upari
उपरिकेंद्र	uparikendr
उपरिवर्ती	uparivartee
उपरिव्यय	uparivyay
उपरिशायी	uparishaayee
उपरी	uparee
उपरोक्त	uparokt
उपरोक्तानुसार	uparoktaanusaar
उपरोप	uparop
उपर्युक्त	uparyukt
उपल	upal
उपलक्ष	upalaksh
उपलक्षक	upalakshak
उपलक्षण	upalakshan
उपलक्षित	upalakshit
उपलक्ष्य	upalakshy
उपलब्द्ध	upalabddh
उपलब्द्धि	upalabddhi
उपलब्ध	upalabdh
उपलब्धता	upalabdhata
उपलब्धि	upalabdhi
उपलब्धियाँ	upalabdhiyaan
उपलब्धियां	upalabdhiyaan
उपलब्धियों	upalabdhiyon
उपलभ्य	upalabhy
उपलवृष्टि	upalavrshti
उपला	upala
उपलेख	upalekh
उपवंश	upavansh
उपवन	upavan
उपवर्गों	upavargon
उपवाक्य	upavaaky
उपवास	upavaas
उपविजेता	upavijeta
उपविधियों	upavidhiyon
उपविष्ट	upavisht
उपवीत	upaveet
उपवीथी	upaveethee
उपवेद	upaved
उपव्यवसाय	upavyavasaay
उपशब्द	upashabd
उपशम	upasham
उपशमन	upashaman
उपशमनीय	upashamaneey
उपशाखा	upashaakha
उपशिक्षक	upashikshak
उपशीर्षक	upasheershak
उपशुल्क	upashulk
उपश्रुति	upashruti
उपश्रेणियाँ	upashreniyaan
उपश्रेणियों	upashreniyon
उपश्रेणी	upashrenee
उपसंपादक	upasampaadak
उपसंवर्ध	upasanvardh
उपसंहार	upasanhaar
उपसचिव	upasachiv
उपसभापति	upasabhaapati
उपसमिति	upasamiti
उपसमुच्चय	upasamuchchay
उपसमूह	upasamooh
उपसर्ग	upasarg
उपसर्गों	upasargon
उपसादन	upasaadan
उपसाधक	upasaadhak
उपसाधन	upasaadhan
उपसौर	upasaur
उपस्कर	upaskar
उपस्करों	upaskaron
उपस्कृत	upaskrt
उपस्तरण	upastaran
उपस्थ	upasth
उपस्थापक	upasthaapak
उपस्थापन	upasthaapan
उपस्थापित	upasthaapit
उपस्थित	upasthit
उपस्थिति	upasthiti
उपस्थितिपंजी	upasthitipanjee
उपस्री	upasree
उपहार	upahaar
उपहारदान	upahaaradaan
उपहारों	upahaaron
उपहास	upahaas
उपहासपूर्ण	upahaasapoorn
उपहासी	upahaasee
उपांग	upaang
उपांगीय	upaangeey
उपांग्	upaang
उपांतिक	upaantik
उपाकर्म	upaakarm
उपाख्यान	upaakhyaan
उपाख्यानात्मक	upaakhyaanaatmak
उपाख्यानों	upaakhyaanon
उपागम	upaagam
उपादान	upaadaan
उपादानों	upaadaanon
उपादेय	upaadey
उपादेयता	upaadeyata
उपाधि	upaadhi
उपाधिधारी	upaadhidhaaree
उपाधिपत्र	upaadhipatr
उपाधियाँ	upaadhiyaan
उपाधियां	upaadhiyaan
उपाधियों	upaadhiyon
उपाधी	upaadhee
उपाध्यक्ष	upaadhyaksh
उपाध्याय	upaadhyaay
उपाध्यायानी	upaadhyaayaanee
उपान	upaan
उपापचय	upaapachay
उपापचयी	upaapachayee
उपाबंध	upaabandh
उपाय	upaay
उपायतः	upaayatah
उपायन	upaayan
उपायुक्त	upaayukt
उपायों	upaayon
उपायोजक	upaayojak
उपार्जन	upaarjan
उपार्जित	upaarjit
उपार्थ	upaarth
उपालंभ	upaalambh
उपाश्रय	upaashray
उपाश्रित	upaashrit
उपासक	upaasak
उपासकों	upaasakon
उपासन	upaasan
उपासना	upaasana
उपासनागृह	upaasanaagrh
उपासनीय	upaasaneey
उपासा	upaasa
उपास्थि	upaasthi
उपास्य	upaasy
उपेंद्र	upendr
उपेक्षक	upekshak
उपेक्षणीय	upekshaneey
उपेक्षा	upeksha
उपेक्षाकारी	upekshaakaaree
उपेक्षापूर्ण	upekshaapoorn
उपेक्षापूर्वक	upekshaapoorvak
उपेक्षावस्था	upekshaavastha
उपेक्षाशील	upekshaasheel
उपेक्षित	upekshit
उपेक्षिता	upekshita
उपेक्ष्य	upekshy
उपेन्द्र	upendr
उपेन्द्रनाथ	upendranaath
उपोत्पाद	upotpaad
उपोष्ण	uposhn
उपोष्णीय	uposhneey
उप्साला	upsaala
उफ	uph
उफनना	uphanana
उफान	uphaan
उबंटू	ubantoo
उबकना	ubakana
उबकाई	ubakaee
उबटन	ubatan
उबर	ubar
उबरकर	ubarakar
उबरना	ubarana
उबरने	ubarane
उबलता	ubalata
उबलते	ubalate
उबलना	ubalana
उबलने	ubalane
उबला	ubala
उबले	ubale
उबाऊ	ubaoo
उबार	ubaar
उबारना	ubaarana
उबारने	ubaarane
उबारा	ubaara
उबाल	ubaal
उबालकर	ubaalakar
उबालते	ubaalate
उबालना	ubaalana
उबालने	ubaalane
उबाला	ubaala
उबालें	ubaalen
उबासी	ubaasee
उब्लांक	ublaank
उब्लियट	ubliyat
उभय	ubhay
उभयचर	ubhayachar
उभयचरों	ubhayacharon
उभयनिष्ठ	ubhayanishth
उभयरोधी	ubhayarodhee
उभयलिंग	ubhayaling
उभयलिंगता	ubhayalingata
उभयलिंगिता	ubhayalingita
उभयलिंगी	ubhayalingee
उभयलैंगिकता	ubhayalaingikata
उभयोष्ट्य	ubhayoshty
उभर	ubhar
उभरकर	ubharakar
उभरता	ubharata
उभरती	ubharatee
उभरते	ubharate
उभरना	ubharana
उभरने	ubharane
उभरा	ubhara
उभरी	ubharee
उभरे	ubhare
उभरेगा	ubharega
उभाड	ubhaad
उभार	ubhaar
उभारक	ubhaarak
उभारदार	ubhaaradaar
उभारना	ubhaarana
उभारने	ubhaarane
उभारा	ubhaara
उभारों	ubhaaron
उभालना	ubhaalana
उभाड़	ubhaad
उभियाना	ubhiyaana
उभड़ना	ubhadana
उभड़नेवाला	ubhadanevaala
उमंग	umang
उमंगें	umangen
उमंगों	umangon
उमग	umag
उमड	umad
उमय्यद	umayyad
उमर	umar
उमरकोट	umarakot
उमरा	umara
उमराव	umaraav
उमरिया	umariya
उमरी	umaree
उमस	umas
उमसपन	umasapan
उमा	uma
उमाकांत	umaakaant
उमानाथ	umaanaath
उमापति	umaapati
उमाशंकर	umaashankar
उमेटना	umetana
उमेठना	umethana
उमेद	umed
उमेश	umesh
उम्दा	umda
उम्मिदवार	ummidavaar
उम्मीद	ummeed
उम्मीदवार	ummeedavaar
उम्मीदवारी	ummeedavaaree
उम्मीदवारों	ummeedavaaron
उम्मीदे	ummeede
उम्मीदें	ummeeden
उम्मीदों	ummeedon
उम्मेद	ummed
उम्र	umr
उम्रकैद	umrakaid
उम्रकैदी	umrakaidee
उम्रक़ैद	umraqaid
उमड़	umad
उमड़ना	umadana
उमड़ने	umadane
उमड़ा	umada
उमड़ाना	umadaana
उमड़ी	umadee
उर	ur
उरई	uree
उरग	urag
उरण	uran
उरद	urad
उरसिज	urasij
उराँव	uraanv
उरी	uree
उरुग्वे	urugve
उरुबू	uruboo
उरेह	ureh
उरोस्थि	urosthi
उर्जा	urja
उर्दु	urdu
उर्दू	urdoo
उर्ध्व	urdhv
उर्ध्वगामी	urdhvagaamee
उर्ध्ववृत्तचिट्र	urdhvavrttachitr
उर्ध्वाधर	urdhvaadhar
उर्मिला	urmila
उर्वर	urvar
उर्वरक	urvarak
उर्वरकों	urvarakon
उर्वरण	urvaran
उर्वरता	urvarata
उर्वराशक्ति	urvaraashakti
उर्वशी	urvashee
उलंघन	ulanghan
उलझ	ulajh
उलझती	ulajhatee
उलझन	ulajhan
उलझना	ulajhana
उलझने	ulajhane
उलझनें	ulajhanen
उलझनों	ulajhanon
उलझा	ulajha
उलझाए	ulajhae
उलझाना	ulajhaana
उलझी	ulajhee
उलझे	ulajhe
उलझेड़ा	ulajheda
उलट	ulat
उलटकर	ulatakar
उलटना	ulatana
उलटनीय	ulataneey
उलटने	ulatane
उलटफेर	ulatapher
उलटवाँसी	ulatavaansee
उलटा	ulata
उलटाना	ulataana
उलटाव	ulataav
उलटी	ulatee
उलटे	ulate
उलथा	ulatha
उलप्य	ulapy
उलमा	ulama
उलहना	ulahana
उलाहना	ulaahana
उलिचना	ulichana
उलूक	ulook
उलूखल	ulookhal
उलूपी	uloopee
उलूम	uloom
उलेमा	ulema
उलेमाओं	ulemaon
उल्का	ulka
उल्कापात	ulkaapaat
उल्कापिंड	ulkaapind
उल्काश्मिक	ulkaashmik
उल्झन	uljhan
उल्टा	ulta
उल्टियाँ	ultiyaan
उल्टी	ultee
उल्टे	ulte
उल्फा	ulpha
उल्लंघन	ullanghan
उल्लंघनों	ullanghanon
उल्लंधन	ullandhan
उल्लघंन	ullaghann
उल्लसित	ullasit
उल्ला	ulla
उल्लास	ullaas
उल्लासपूर्ण	ullaasapoorn
उल्लासोन्माद	ullaasonmaad
उल्लाह	ullaah
उल्लिखित	ullikhit
उल्लू	ulloo
उल्लेख	ullekh
उल्लेखन	ullekhan
उल्लेखनीय	ullekhaneey
उल्लेखित	ullekhit
उल्लेखों	ullekhon
उल्स्टर	ulstar
उल्हास	ulhaas
उल्हासनगर	ulhaasanagar
उल्हासपूर्वक	ulhaasapoorvak
उष	ush
उषा	usha
उषाकर	ushaakar
उषाकाल	ushaakaal
उष्ण	ushn
उष्णकटिबंध	ushnakatibandh
उष्णकटिबंधीय	ushnakatibandheey
उष्णकटिबन्ध	ushnakatibandh
उष्णकटिबन्धी	ushnakatibandhee
उष्णकाल	ushnakaal
उष्णता	ushnata
उष्णप्रदेशीय	ushnapradesheey
उष्णीष	ushneesh
उष्णोत्स	ushnots
उष्म	ushm
उष्मक	ushmak
उष्मा	ushma
उष्मिक	ushmik
उष्मीय	ushmeey
उस	us
उसक	usak
उसका	usaka
उसकी	usakee
उसके	usake
उसको	usako
उसनना	usanana
उसने	usane
उसपर	usapar
उसमान	usamaan
उसमे	usame
उसमें	usamen
उसर	usar
उसरी	usaree
उससे	usase
उसास	usaas
उसी	usee
उसीके	useeke
उसीसा	useesa
उसूल	usool
उसूलों	usoolon
उसे	use
उस्तरा	ustara
उस्ता	usta
उस्ताद	ustaad
उस्तादी	ustaadee
उस्तादों	ustaadon
उस्तुरा	ustura
उस्मान	usmaan
उस्मानपुर	usmaanapur
उस्मानिया	usmaaniya
उस्मानी	usmaanee
उहापोह	uhaapoh
उक़ाब	uqaab
उज़बेकिस्तान	uzabekistaan
उज़्बेक	uzbek
उज़्बेकिस्तान	uzbekistaan
उड़कर	udakar
उड़ते	udate
उड़द	udad
उड़न	udan
उड़नदस्ता	udanadasta
उड़ना	udana
उड़ने	udane
उड़नेवाला	udanevaala
उड़ा	uda
उड़ाई	udaee
उड़ाऊ	udaoo
उड़ाकर	udaakar
उड़ाका	udaaka
उड़ाते	udaate
उड़ान	udaan
उड़ाना	udaana
उड़ाने	udaane
उड़ानें	udaanen
उड़ानों	udaanon
उड़ाया	udaaya
उड़िसा	udisa
उड़ीसा	udeesa
उड़े	ude
उड़ेलना	udelana
उढ़री	udharee
उफ़	uf
ऊँ	oon
ऊँगलियों	oongaliyon
ऊँगली	oongalee
ऊँघ	oongh
ऊँच	oonch
ऊँचा	ooncha
ऊँचाइयाँ	oonchaiyaan
ऊँचाइयों	oonchaiyon
ऊँचाई	oonchaee
ऊँची	oonchee
ऊँचे	oonche
ऊँचें	oonchen
ऊँट	oont
ऊँटनी	oontanee
ऊँटों	oonton
ऊंगली	oongalee
ऊंघना	oonghana
ऊंघाई	oonghaee
ऊंच	oonch
ऊंचा	ooncha
ऊंचाइयों	oonchaiyon
ऊंचाई	oonchaee
ऊंचाहार	oonchaahaar
ऊंची	oonchee
ऊंचे	oonche
ऊंट	oont
ऊंटी	oontee
ऊंटों	oonton
ऊख	ookh
ऊखल	ookhal
ऊचाई	oochaee
ऊजल	oojal
ऊजड़	oojad
ऊटपटांग	ootapataang
ऊटी	ootee
ऊतक	ootak
ऊतकीय	ootakeey
ऊतकों	ootakon
ऊति	ooti
ऊदबिलाव	oodabilaav
ऊदल	oodal
ऊदा	ooda
ऊधमसिंह	oodhamasinh
ऊधमी	oodhamee
ऊन	oon
ऊनदार	oonadaar
ऊनी	oonee
ऊपर	oopar
ऊपरवाला	ooparavaala
ऊपरवाले	ooparavaale
ऊपरी	ooparee
ऊफान	oophaan
ऊब	oob
ऊबना	oobana
ऊबाना	oobaana
ऊमर	oomar
ऊमलायूट	oomalaayoot
ऊरु	ooru
ऊर्जस्विता	oorjasvita
ऊर्जा	oorja
ऊर्जावान	oorjaavaan
ऊर्जित	oorjit
ऊर्णायु	oornaayu
ऊर्दू	oordoo
ऊर्ध्व	oordhv
ऊर्ध्वगामी	oordhvagaamee
ऊर्ध्वता	oordhvata
ऊर्ध्वमुखी	oordhvamukhee
ऊर्ध्वरघात	oordhvaraghaat
ऊर्ध्वा	oordhva
ऊर्ध्वाधर	oordhvaadhar
ऊल	ool
ऊलना	oolana
ऊषर	ooshar
ऊषा	oosha
ऊष्मप्रवैगिकी	ooshmapravaigikee
ऊष्मा	ooshma
ऊष्मायन	ooshmaayan
ऊष्मायित्र	ooshmaayitr
ऊष्मीय	ooshmeey
ऊसन्धि	oosandhi
ऊसर	oosar
ऊहा	ooha
ऊहापोह	oohaapoh
ऊफ़ा	oofa
ऋक्	rk
ऋगवेद	rgaved
ऋग्	rg
ऋग्वेद	rgved
ऋग्वेदीय	rgvedeey
ऋग्वैदिक	rgvaidik
ऋचा	rcha
ऋचाएँ	rchaen
ऋचाओं	rchaon
ऋचीक	rcheek
ऋजु	rju
ऋण	rn
ऋणग्रस्त	rnagrast
ऋणग्रस्तता	rnagrastata
ऋणदाता	rnadaata
ऋणदाताओं	rnadaataon
ऋणदान	rnadaan
ऋणशोधनाक्षम	rnashodhanaaksham
ऋणात्मक	rnaatmak
ऋणात्मकता	rnaatmakata
ऋणों	rnon
ऋत	rt
ऋतिक	rtik
ऋतु	rtu
ऋतुओं	rtuon
ऋतुक्षरित	rtuksharit
ऋतुदर्शक	rtudarshak
ऋतुनिष्ट	rtunisht
ऋतुराज	rturaaj
ऋतुस्राव	rtusraav
ऋत्विक	rtvik
ऋद्धि	rddhi
ऋषभ	rshabh
ऋषभदेव	rshabhadev
ऋषि	rshi
ऋषिकेश	rshikesh
ऋषियों	rshiyon
ऍ	ai
ऍक्स	aiks
ऍक्सपी	aiksapee
ऍडीटर	aideetar
ऍप्लिकेशन	aiplikeshan
ऍप्लीकेशन	aipleekeshan
ऍम	aim
ऍफ़	aif
एँ	en
एंकर	enkar
एंक्लेव	enklev
एंगल	engal
एंगस	engas
एंगांग	engaang
एंगेल्स	engels
एंग्री	engree
एंग्लिकन	englikan
एंग्लो	englo
एंजल	enjal
एंजल्स	enjals
एंजाइम	enjaim
एंजाइमों	enjaimon
एंजियोग्राफी	enjiyograaphee
एंजियोप्लास्टी	enjiyoplaastee
एंजिल	enjil
एंजिलिस	enjilis
एंजिल्स	enjils
एंजेल	enjel
एंजेला	enjela
एंजेलिना	enjelina
एंजेलीना	enjeleena
एंजेलो	enjelo
एंजेल्स	enjels
एंटनी	entanee
एंटरटेनमेंट	entaratenament
एंटरप्राइज	entarapraij
एंटरप्राइज़	entarapraiz
एंटवर्प	entavarp
एंटिटी	entitee
एंटिना	entina
एंटिलिआन	entiliaan
एंटिल्स	entils
एंटी	entee
एंटीऑक्सीडेंट	enteeokseedent
एंटीक	enteek
एंटीगुआ	enteegua
एंटीजन	enteejan
एंटीना	enteena
एंटीफ्ऱीज़र	enteephreezar
एंटीबायोटिक	enteebaayotik
एंटीबायोटिक्स	enteebaayotiks
एंटीबॉडी	enteebodee
एंटीबॉयटिक	enteeboyatik
एंटीमनी	enteemanee
एंटीवायरस	enteevaayaras
एंटीसेप्टिक	enteeseptik
एंटेना	entena
एंटोन	enton
एंटोनियो	entoniyo
एंटोनी	entonee
एंट्री	entree
एंडनोट	endanot
एंडरसन	endarasan
एंडी	endee
एंडोक्राइन	endokrain
एंडोक्राइन	endokrain
एंडोस्कोप	endoskop
एंडोस्कोपी	endoskopee
एंड्योिंरग	endyoinrag
एंड्रयू	endrayoo
एंड्रयूज	endrayooj
एंड्रिया	endriya
एंड्रू	endroo
एंड्रॉयड	endroyad
एंड्रोमेडा	endromeda
एंड्र्यू	endryoo
एंथनी	enthanee
एंथोनी	enthonee
एंथ्रेक्स	enthreks
एंथ्रोपोलॉजी	enthropolojee
एंपोरियम	emporiyam
एंबुलेंस	embulens
एंबेसडर	embesadar
एंरेगोनाइट	enregonait
एंव	env
एंसन	ensan
एंज़ाइम	enzaim
एअर	ear
एअरटाइम	earataim
एअरपोर्ट	earaport
एअरलाइंस	earalains
एअरलाइन	earalain
एआईआर	eaeeaar
एएन	een
एएनएसआई	eenesaee
एएफसी	eephasee
एएस	ees
एक	ek
एकक	ekak
एककार्मिक	ekakaarmik
एककों	ekakon
एकचक्र	ekachakr
एकचारी	ekachaaree
एकछत्र	ekachhatr
एकजुट	ekajut
एकजुटता	ekajutata
एकटक	ekatak
एकड	ekad
एकतंत्र	ekatantr
एकतंत्रीय	ekatantreey
एकतरफा	ekatarapha
एकतरफ़ा	ekatarafa
एकता	ekata
एकतानता	ekataanata
एकतारा	ekataara
एकताल	ekataal
एकत्र	ekatr
एकत्रण	ekatran
एकत्रित	ekatrit
एकत्रीकरण	ekatreekaran
एकत्व	ekatv
एकत्ववाद	ekatvavaad
एकदम	ekadam
एकदिन	ekadin
एकदिल	ekadil
एकदिवसीय	ekadivaseey
एकदूसरे	ekadoosare
एकध्रुवीय	ekadhruveey
एकनाथ	ekanaath
एकनिष्ठ	ekanishth
एकनिष्ठा	ekanishtha
एकपक्षीय	ekapaksheey
एकबरसी	ekabarasee
एकबार	ekabaar
एकबारगी	ekabaaragee
एकभाषिक	ekabhaashik
एकमत	ekamat
एकमात्र	ekamaatr
एकमुखी	ekamukhee
एकमुश्त	ekamusht
एकरस	ekaras
एकरसता	ekarasata
एकरूप	ekaroop
एकरूपता	ekaroopata
एकल	ekal
एकलपद	ekalapad
एकलव्य	ekalavy
एकला	ekala
एकलिंग	ekaling
एकलिंगजी	ekalingajee
एकलिंगी	ekalingee
एकलौता	ekalauta
एकवचन	ekavachan
एकविंश	ekavinsh
एकशः	ekashah
एकसदनी	ekasadanee
एकसम	ekasam
एकसमान	ekasamaan
एकसमानता	ekasamaanata
एकसा	ekasa
एकसाँ	ekasaan
एकसाथ	ekasaath
एकसार	ekasaar
एकसुरा	ekasura
एकस्व	ekasv
एकस्वर	ekasvar
एकस्वरता	ekasvarata
एकहत्था	ekahattha
एकहि	ekahi
एकांकी	ekaankee
एकांग	ekaang
एकांगी	ekaangee
एकांत	ekaant
एकांतप्रिय	ekaantapriy
एकांतप्रियता	ekaantapriyata
एकांतभीति	ekaantabheeti
एकांतर	ekaantar
एकांतवास	ekaantavaas
एकांतवासी	ekaantavaasee
एकांतिक	ekaantik
एकांश	ekaansh
एकाउंट	ekaunt
एकाउंटिंग	ekaunting
एकाउंटेंट	ekauntent
एकाउंटेंट्स	ekauntents
एकाउंटेंसी	ekauntensee
एकाएक	ekaek
एकाकार	ekaakaar
एकाकारता	ekaakaarata
एकाकी	ekaakee
एकाकीपन	ekaakeepan
एकाग्र	ekaagr
एकाग्रचित्त	ekaagrachitt
एकाग्रता	ekaagrata
एकाग्रित	ekaagrit
एकाडमी	ekaadamee
एकात्म	ekaatm
एकात्मकता	ekaatmakata
एकात्मता	ekaatmata
एकादश	ekaadash
एकादशियाँ	ekaadashiyaan
एकादशी	ekaadashee
एकाध	ekaadh
एकाधिक	ekaadhik
एकाधिकार	ekaadhikaar
एकाधिकारप्राप्त	ekaadhikaarapraapt
एकान्त	ekaant
एकान्तता	ekaantata
एकान्तमयता	ekaantamayata
एकान्तरिक	ekaantarik
एकालाप	ekaalaap
एकाश्म	ekaashm
एकीकरण	ekeekaran
एकीकृत	ekeekrt
एकु	eku
एके	eke
एकेडमी	ekedamee
एकेडेमी	ekedemee
एकेश्वरवाद	ekeshvaravaad
एकैकी	ekaikee
एकॉन	ekon
एकॉर्ड	ekord
एक्	ek
एक्का	ekka
एक्जिमा	ekjima
एक्जीक्यूटिव	ekjeekyootiv
एक्ट	ekt
एक्टर	ektar
एक्टर्स	ektars
एक्टिंग	ekting
एक्टिव	ektiv
एक्ट्रेस	ektres
एक्य	eky
एक्यूट	ekyoot
एक्यूपंक्चर	ekyoopankchar
एक्यूपंचर	ekyoopanchar
एक्यूप्रेशर	ekyoopreshar
एक्राइलोनाइट्राइल	ekrailonaitrail
एक्रोबैट	ekrobait
एक्लिप्स	eklips
एक्वा	ekva
एक्वायर्ड	ekvaayard
एक्वेरियम	ekveriyam
एक्वैरियम	ekvairiyam
एक्शन	ekshan
एक्स	eks
एक्सएमएल	eksemel
एक्सएल	eksel
एक्सक्लूसिव	eksakloosiv
एक्सचेंज	eksachenj
एक्सचेंजर	eksachenjar
एक्सचेंजों	eksachenjon
एक्सटर्नल	eksatarnal
एक्सटेंशन	eksatenshan
एक्सटेसी	eksatesee
एक्सट्रीम	eksatreem
एक्सपर्ट	eksapart
एक्सपीरियंस	eksapeeriyans
एक्सपो	eksapo
एक्सपोजर	eksapojar
एक्सप्रेशन	eksapreshan
एक्सप्रेस	eksapres
एक्सप्रेसवे	eksapresave
एक्सप्लोरर	eksaplorar
एक्सप्लोरेशन	eksaploreshan
एक्सबॉक्स	eksaboks
एक्सरे	eksare
एक्सल	eksal
एक्सिलरेटर	eksilaretar
एक्सिस	eksis
एक्सीडेंट	ekseedent
एक्सेंट	eksent
एक्सेंटर	eksentar
एक्सेल	eksel
एक्सेस	ekses
एक्सेसरी	eksesaree
एक्सेसरीज़	eksesareez
एक्सॉन	ekson
एक्सोड़र्म	eksodarm
एक्स्टेंशन	ekstenshan
एक्स्टेंसिबल	ekstensibal
एक्स्ट्रा	ekstra
एक्स्ट्रेक्टिंग	ekstrekting
एक्स्पोजर	ekspojar
एक्स्प्रेस	ekspres
एक्स्प्लोरर	eksplorar
एक्सफ़ोलीएटिंग	eksafoleeeting
एक्ज़िट	ekzit
एकड़	ekad
एग	eg
एगप्लांट	egaplaant
एगमोर	egamor
एगलिट्	egalit
एगी	egee
एग्जाम	egjaam
एग्नेस	egnes
एग्मोर	egmor
एग्रीकल्चर	egreekalchar
एग्रीकल्चरल	egreekalcharal
एग्रीगेटर	egreegetar
एग्रीमेंट	egreement
एग्रो	egro
एग्ज़िस्टंत्सियनलिज़म	egzistantsiyanalizam
एचआइवी	echaivee
एचएएल	echeel
एचएसबीसी	echesabeesee
एचटीटीपी	echateeteepee
एचडी	echadee
एचडीएफसी	echadeeephasee
एचडीएमआई	echadeeemaee
एचपी	echapee
एचपीसीएल	echapeeseeel
एचबीओ	echabeeo
एचसीएल	echaseeel
एचिंग	eching
एचीवमेंट	echeevament
एच्छिक	echchhik
एज	ej
एजंट	ejant
एजंसी	ejansee
एजन्ट	ejant
एजबेस्टन	ejabestan
एजाइल	ejail
एजाज़	ejaaz
एजिंग	ejing
एजुकेशन	ejukeshan
एजुकेशनल	ejukeshanal
एजूकेशन	ejookeshan
एजेंट	ejent
एजेंटों	ejenton
एजेंडा	ejenda
एजेंडे	ejende
एजेंसियाँ	ejensiyaan
एजेंसियां	ejensiyaan
एजेंसियों	ejensiyon
एजेंसी	ejensee
एजेन्ट	ejent
एजेन्टों	ejenton
एजेन्सियों	ejensiyon
एजेन्सी	ejensee
एजोला	ejola
एझावा	ejhaava
एटकिंसन	etakinsan
एटम	etam
एटमी	etamee
एटलस	etalas
एटलांटा	etalaanta
एटलांटिक	etalaantik
एटलेटिको	etaletiko
एटवुड	etavud
एटा	eta
एटी	etee
एटीआर	eteeaar
एटीएम	eteeem
एटीपी	eteepee
एटॉमिक	etomik
एटॉर्नी	etornee
एटोल	etol
एडगर	edagar
एडजस्ट	edajast
एडम	edam
एडमंड	edamand
एडमिनिस्ट्रेटर	edaministretar
एडमिनिस्ट्रेशन	edaministreshan
एडमिरल	edamiral
एडमिशन	edamishan
एडम्स	edams
एडलर	edalar
एडल्ट	edalt
एडवर्ड	edavard
एडवर्ड्स	edavards
एडवांटेज	edavaantej
एडवांस	edavaans
एडवांस्ड	edavaansd
एडविन	edavin
एडवेंचर	edavenchar
एडवेंचर्स	edavenchars
एडवोकेट	edavoket
एडाप्टर	edaaptar
एडिट	edit
एडिटर	editar
एडिटर्स	editars
एडिटिंग	editing
एडिडास	edidaas
एडिनबरा	edinabara
एडिनबर्ग	edinabarg
एडिलेड	ediled
एडिशन	edishan
एडिसन	edisan
एडी	edee
एडीआर	edeeaar
एडीए	edeee
एडीएचडी	edeeechadee
एडीज	edeej
एडीटर	edeetar
एडीबी	edeebee
एडीलेड	edeeled
एडीशनल	edeeshanal
एडुकेशन	edukeshan
एडेड	eded
एडेलवेइस	edelaveis
एडोब	edob
एडोल्फ	edolph
एड्नेक्सा	edneksa
एड्रियन	edriyan
एड्रियाटिक	edriyaatik
एड्रेनालाईन	edrenaalaeen
एड्रेस	edres
एड्वर्ड	edvard
एड्वेक्सन	edveksan
एड्स	eds
एण्ड	end
एण्डरसन	endarasan
एत	et
एतदवधि	etadavadhi
एतद्	etad
एतद्द्वारा	etaddvaara
एतना	etana
एतबार	etabaar
एतमादपुर	etamaadapur
एतराज	etaraaj
एतराज़	etaraaz
एतादृश	etaadrsh
एतान	etaan
एतिहासिक	etihaasik
एथनॉल	ethanol
एथलीट	ethaleet
एथलीटों	ethaleeton
एथलेटिक	ethaletik
एथलेटिक्स	ethaletiks
एथिक्स	ethiks
एथिल	ethil
एथिलीन	ethileen
एथीन	etheen
एथेंस	ethens
एथेन	ethen
एधा	edha
एनआईआईटी	enaeeaeetee
एनआईटी	enaeetee
एनआईपीईआर	enaeepeeeeaar
एनईआर	eneeaar
एनएएल	eneel
एनएच	enech
एनएचके	enechake
एनएम	enem
एनएलपी	enelapee
एनएसई	enesee
एनएसजी	enesajee
एनएसडब्ल्यू	enesadablyoo
एनकाउन्टर	enakauntar
एनकोड	enakod
एनकोडर	enakodar
एनकोडिंग	enakoding
एनक्रिप्शन	enakripshan
एनग्रेविंग	enagreving
एनजाइना	enajaina
एनटाइटेलमेंट	enataitelament
एनटी	enatee
एनटीटी	enateetee
एनटीपीसी	enateepeesee
एनडी	enadee
एनडीए	enadeee
एनडीटीवी	enadeeteevee
एनफील्ड	enapheeld
एनबीए	enabeee
एनबीसी	enabeesee
एनरिक	enarik
एनरिको	enariko
एनरॉन	enaron
एनर्जी	enarjee
एनवलप	enavalap
एनवाई	enavaee
एनवायरनमेंट	enavaayaranament
एनसाइक्लोपीडिया	enasaiklopeediya
एनसीआर	enaseeaar
एनसीईआरटी	enaseeeeaaratee
एनसीएए	enaseeee
एनहाइड्राइड	enahaidraid
एना	ena
एनाटॉमी	enaatomee
एनामॉर्फिक	enaamorphik
एनालाइजर	enaalaijar
एनालिसिस	enaalisis
एनालॉग	enaalog
एनाल्जेसिक	enaaljesik
एनिग्मा	enigma
एनिमल	enimal
एनिमा	enima
एनिमी	enimee
एनिमेटेड	enimeted
एनिमेशन	enimeshan
एनिसेट	eniset
एनीमा	eneema
एनीमिया	eneemiya
एनीमेटेड	eneemeted
एनीमेशन	eneemeshan
एनेक्सी	eneksee
एनेस्थिसियोलॉजी	enesthisiyolojee
एनेस्थेटिस्ट	enesthetist
एनेस्थेसिया	enesthesiya
एनोटेशन	enoteshan
एनोरेक्सिया	enoreksiya
एन्कलेव	enkalev
एन्कोडिंग	enkoding
एन्क्रिप्ट	enkript
एन्क्रिप्टेड	enkripted
एन्क्रिप्शन	enkripshan
एन्क्लेव	enklev
एन्जाइम	enjaim
एन्टी	entee
एन्टी	entee
एन्ट्री	entree
एन्ड	end
एन्ड्रेस	endres
एन्थनी	enthanee
एन्ना	enna
एन्नोर	ennor
एन्साइक्लोपीडिया	ensaiklopeediya
एन्हिंगा	enhinga
एन्ज़ाइम	enzaim
एपर्चर	eparchar
एपिस	epis
एपिसोड	episod
एपिसोडों	episodon
एपीजे	epeeje
एपीसोड	epeesod
एपेक्स	epeks
एपेटाइट	epetait
एप्पल	eppal
एप्रन	epran
एप्रॉन	epron
एप्लाइड	eplaid
एप्लिकेशन	eplikeshan
एप्लीकेशंस	epleekeshans
एप्लीकेशन	epleekeshan
एप्लेट	eplet
एफआईआर	ephaeeaar
एफए	ephe
एफटीपी	ephateepee
एफडीए	ephadeee
एफबीआई	ephabeeaee
एफसी	ephasee
एफसीसी	ephaseesee
एफिल	ephil
एफ्रो	ephro
एबल	ebal
एबी	ebee
एबीवी	ebeevee
एबीसी	ebeesee
एबेन	eben
एबौम	ebaum
एबौर	ebaur
एब्डायस	ebdaayas
एब्बे	ebbe
एमआईटी	emaeetee
एमआरआई	emaaraee
एमएफ	emeph
एमएम	emem
एमएमटीसी	ememateesee
एमएल	emel
एमएलए	emele
एमएस	emes
एमएसएन	emesen
एमएससी	emesasee
एमकेआई	emakeaee
एमजीआर	emajeeaar
एमजीएम	emajeeem
एमटीएनएल	emateeenel
एमटीपीए	emateepeee
एमटीवी	emateevee
एमडी	emadee
एमनियोटिक	emaniyotik
एमनेस्टी	emanestee
एमपी	emapee
एमबीबीएस	emabeebeees
एमरी	emaree
एमवी	emavee
एमसी	emasee
एमसीए	emaseee
एमहारा	emahaara
एमा	ema
एमिगा	emiga
एमिनेम	eminem
एमिनो	emino
एमिरेट्स	emirets
एमिल	emil
एमिली	emilee
एमी	emee
एमु	emu
एमुलेटर	emuletar
एमू	emoo
एमेच्योर	emechyor
एम्परर	emparar
एम्परसेंड	emparasend
एम्पलीफायर	empaleephaayar
एम्पायर	empaayar
एम्पीयर	empeeyar
एम्पेयर	empeyar
एम्पोरियम	emporiyam
एम्प्लिफायर	empliphaayar
एम्बर	embar
एम्बुलेंस	embulens
एम्बेड	embed
एम्बेडेड	embeded
एम्सटर्डम	emsatardam
एम्स्टर्डम	emstardam
एम्फ़ैटेमिन	emfaitemin
एयर	eyar
एयरक्राफ्ट	eyarakraapht
एयरटेल	eyaratel
एयरपोर्ट	eyaraport
एयरपोर्ट्स	eyaraports
एयरबस	eyarabas
एयरबैग	eyarabaig
एयरबोर्न	eyaraborn
एयरमैन	eyaramain
एयरलाइंस	eyaralains
एयरलाइन	eyaralain
एयरलाइनर	eyaralainar
एयरलाइनों	eyaralainon
एयरलाइन्स	eyaralains
एयरलाईन्स	eyaralaeens
एयरवेज	eyaravej
एयरवेज़	eyaravez
एयरसेल	eyarasel
एयरो	eyaro
एयरोनॉटिक्स	eyaronotiks
एयरोस्पेस	eyarospes
एर	er
एरंड	erand
एरण्ड	erand
एरनाकुलम	eranaakulam
एरर	erar
एरर्स	erars
एरा	era
एरिक	erik
एरिका	erika
एरिक्सन	eriksan
एरिजोना	erijona
एरिथ्रोसाइट	erithrosait
एरियन	eriyan
एरियल	eriyal
एरिया	eriya
एरियाना	eriyaana
एरिज़ोना	erizona
एरीजोना	ereejona
एरीना	ereena
एरे	ere
एरेना	erena
एरो	ero
एरोन	eron
एरोबिक	erobik
एरोविलय	erovilay
एरोस्टैट्	erostait
एरोस्मिथ	erosmith
एर्ग	erg
एर्नाकुलम	ernaakulam
एर्न्स्ट	ernst
एलईडी	eleedee
एलएचसी	elechasee
एलएलपी	elelapee
एलएलसी	elelasee
एलची	elachee
एलजी	elajee
एलटीटीई	elateeteeee
एलडीएल	eladeeel
एलन	elan
एलपी	elapee
एलपीजी	elapeejee
एलबम	elabam
एलबीडब्ल्यू	elabeedablyoo
एलबेट्रॉस	elabetros
एलम	elam
एलरजेन	elarajen
एलर्जिक	elarjik
एलर्जी	elarjee
एलर्ट	elart
एला	ela
एलान	elaan
एलायंस	elaayans
एलिजा	elija
एलिजाबेथ	elijaabeth
एलिन	elin
एलिमेंट	eliment
एलिमेंट्स	eliments
एलियंस	eliyans
एलियट	eliyat
एलियन	eliyan
एलियास	eliyaas
एलिवेटर	elivetar
एलिस	elis
एलिसन	elisan
एलिसा	elisa
एलिस्टेयर	elisteyar
एलिज़ाबेथ	elizaabeth
एलीना	eleena
एलीनोर	eleenor
एलीफेंटा	eleephenta
एलील	eleel
एलीसन	eleesan
एले	ele
एलेक	elek
एलेक्जेंडर	elekjendar
एलेक्ट्रान	elektraan
एलेक्ट्रानिक	elektraanik
एलेक्ट्रानिकी	elektraanikee
एलेक्ट्रॉन	elektron
एलेक्ट्रॉनिक	elektronik
एलेक्ट्रॉनिकी	elektronikee
एलेक्स	eleks
एलेन	elen
एलेम्बिक	elembik
एलोपैथिक	elopaithik
एलोपैथी	elopaithee
एलोरा	elora
एल्क	elk
एल्कोहॉल	elkohol
एल्गिन	elgin
एल्गोरिथम	elgoritham
एल्गोरिदम	elgoridam
एल्टन	eltan
एल्डर	eldar
एल्डिहाइड	eldihaid
एल्पाइन	elpain
एल्बम	elbam
एल्बर्ट	elbart
एल्बो	elbo
एल्मर	elmar
एल्युमिनियम	elyuminiyam
एल्युमीनियम	elyumeeniyam
एल्यूमिना	elyoomina
एल्यूमिनियम	elyoominiyam
एल्यूमीनियम	elyoomeeniyam
एल्लोरा	ellora
एल्वर	elvar
एल्विन	elvin
एल्विस	elvis
एल्स	els
एव	ev
एवँ	evan
एवं	evan
एवज	evaj
एवजी	evajee
एवम	evam
एवम्	evam
एवर	evar
एवरग्रीन	evaragreen
एवरी	evaree
एवरेज	evarej
एवरेस्ट	evarest
एवर्ट	evart
एवर्टन	evartan
एवलिन	evalin
एवा	eva
एवार्ड	evaard
एविएटर	evietar
एविएशन	evieshan
एविडेंस	evidens
एवियन	eviyan
एवियोनिक्स	eviyoniks
एविल	evil
एवज़ी	evazee
एशले	eshale
एशिक	eshik
एशियन	eshiyan
एशिया	eshiya
एशियाई	eshiyaee
एशियाटिक	eshiyaatik
एशियायी	eshiyaayee
एशियावासी	eshiyaavaasee
एशेज	eshej
एश्ले	eshle
एष	esh
एसआर	esaar
एसईसी	eseesee
एसए	ese
एसएम	esem
एसएससी	esesasee
एसके	esake
एसटी	esatee
एसटीडी	esateedee
एसपी	esapee
एसपीएफ़	esapeeef
एसबीआई	esabeeaee
एसयू	esayoo
एसयूवी	esayoovee
एससी	esasee
एससीआर	esaseeaar
एसा	esa
एसिटाइल	esitail
एसिटिक	esitik
एसिटिलीकरण	esitileekaran
एसिटिलीन	esitileen
एसिटैल	esitail
एसिड	esid
एसिडिटी	esiditee
एसीटिलीन	eseetileen
एसीटेट	eseetet
एसीटोन	eseeton
एसीटोनमेह	eseetonameh
एसीपी	eseepee
एसीयनअ	eseeyan
एसीसी	eseesee
एसे	ese
एसेक्स	eseks
एसेम्बली	esembalee
एसेसमेंट	esesament
एसैक्स	esaiks
एसोप	esop
एसोसिएट	esosiet
एसोसिएटेड	esosieted
एसोसिएट्स	esosiets
एसोसिएशन	esosieshan
एसोसियेशन	esosiyeshan
एस्कर	eskar
एस्कालोप	eskaalop
एस्किमो	eskimo
एस्केप	eskep
एस्केलेटर	eskeletar
एस्केलेटेर	eskeleter
एस्कॉर्ट्स	eskorts
एस्कोबार	eskobaar
एस्क्रितुअ	eskritu
एस्टन	estan
एस्टर	estar
एस्टरीकरण	estareekaran
एस्टेट	estet
एस्टोनिया	estoniya
एस्टोनियाई	estoniyaee
एस्ट्रैगन	estraigan
एस्ट्रो	estro
एस्ट्रोजन	estrojan
एस्ट्रोजेन	estrojen
एस्ट्रोजेन	estrojen
एस्तोनिया	estoniya
एस्पिरिन	espirin
एस्पिरीन	espireen
एस्पेन	espen
एस्पेरान्तो	esperaanto
एस्प्रिट	esprit
एस्प्रेसो	espreso
एस्फाल्ट	esphaalt
एस्बेस्टस	esbestas
एस्सार	essaar
एहतियात	ehatiyaat
एहतियाती	ehatiyaatee
एहद	ehad
एहसान	ehasaan
एहसानमंद	ehasaanamand
एहसानमन्द	ehasaanamand
एहसास	ehasaas
एहि	ehi
एही	ehee
एहोय	ehoy
एज़्टेक	eztek
एड़	ed
एड़वान्टेज	edavaantej
एड़ियों	ediyon
एड़ी	edee
एफ़टीपी	efateepee
एफ़बीआई	efabeeaee
एफ़र्ट	efart
एफ़िल	efil
ऐंकर	ainkar
ऐंगल	aingal
ऐंग्लिकन	ainglikan
ऐंग्लो	ainglo
ऐंग्स्ट्रम	aingstram
ऐंटिना	aintina
ऐंटीमनी	ainteemanee
ऐंठ	ainth
ऐंठकर	ainthakar
ऐंठन	ainthan
ऐंठना	ainthana
ऐंठा	aintha
ऐंड	aind
ऐंडरसन	aindarasan
ऐंड्रू	aindroo
ऐंद्र	aindr
ऐंद्रिय	aindriy
ऐंप्यूल	aimpyool
ऐंबर	aimbar
ऐंबुलेंस	aimbulens
ऐंफ़ेटमीन	aimfetameen
ऐकरौन	aikaraun
ऐकरौनी	aikaraunee
ऐकांतिक	aikaantik
ऐकिक	aikik
ऐकिसन	aikisan
ऐक्ट	aikt
ऐक्टन	aiktan
ऐक्टर	aiktar
ऐक्टिंग	aikting
ऐक्टिनाइड	aiktinaid
ऐक्टिनोग्राम	aiktinograam
ऐक्टिनोग्राफ़	aiktinograaf
ऐक्टिनोपौड	aiktinopaud
ऐक्टिनोमीटर	aiktinomeetar
ऐक्टिनौइड	aiktinauid
ऐक्टिव	aiktiv
ऐक्टीनियम	aikteeniyam
ऐक्ट्रेस	aiktres
ऐक्ट्स	aikts
ऐक्य	aiky
ऐक्रिलन	aikrilan
ऐक्रिलिक	aikrilik
ऐक्रोलीन	aikroleen
ऐक्वा	aikva
ऐक्शन	aikshan
ऐक्स	aiks
ऐक्सेस	aikses
ऐक्ज़िरौफ़्थौल	aikziraufthaul
ऐच्छिक	aichchhik
ऐज	aij
ऐजंसियों	aijansiyon
ऐड	aid
ऐडम	aidam
ऐडमिनिस्ट्रेटर	aidaministretar
ऐडमिनिस्ट्रेशन	aidaministreshan
ऐडमिरल	aidamiral
ऐडम्स	aidams
ऐडविल	aidavil
ऐडसेंस	aidasens
ऐडिनीन	aidineen
ऐडिसन	aidisan
ऐडी	aidee
ऐडोनिक	aidonik
ऐड्रेसोग्राफ़	aidresograaf
ऐतराज	aitaraaj
ऐतराज़	aitaraaz
ऐतरेय	aitarey
ऐतिहासिक	aitihaasik
ऐतिहासिकता	aitihaasikata
ऐनक	ainak
ऐना	aina
ऐनाबीना	ainaabeena
ऐनिमे	ainime
ऐनिमोन	ainimon
ऐनी	ainee
ऐन्चोवी	ainchovee
ऐन्टेना	aintena
ऐन्ड	aind
ऐन्द्रजालिक	aindrajaalik
ऐन्द्रिक	aindrik
ऐन्यूरा	ainyoora
ऐपल	aipal
ऐप्लीके	aipleeke
ऐप्लीकेशन	aipleekeshan
ऐप्स	aips
ऐब	aib
ऐबक	aibak
ऐबे	aibe
ऐबेंपियर	aibempiyar
ऐबेम्प	aibemp
ऐब्टाबाद	aibtaabaad
ऐब्स	aibs
ऐम	aim
ऐमीटर	aimeetar
ऐम्परसैंड	aimparasaind
ऐम्पियर	aimpiyar
ऐम्प्लीफ़ायर	aimpleefaayar
ऐम्बुलेंस	aimbulens
ऐम्स्टर्डैम	aimstardaim
ऐयारी	aiyaaree
ऐयाशी	aiyaashee
ऐरावत	airaavat
ऐरावती	airaavatee
ऐरे	aire
ऐरोनॉटिक्स	aironotiks
ऐल	ail
ऐलकोहल	ailakohal
ऐलन	ailan
ऐलबम	ailabam
ऐलम	ailam
ऐलर्जी	ailarjee
ऐलान	ailaan
ऐलिस	ailis
ऐली	ailee
ऐलुमिनियम	ailuminiyam
ऐले	aile
ऐल्कोहल	ailkohal
ऐल्कोहॉल	ailkohol
ऐल्डौल	aildaul
ऐल्प्स	ailps
ऐल्बम	ailbam
ऐल्बेट्रॉस	ailbetros
ऐल्युमिना	ailyumina
ऐल्युमिनियम	ailyuminiyam
ऐल्युमीनियम	ailyumeeniyam
ऐल्यूमिनियम	ailyoominiyam
ऐल्वा	ailva
ऐल्फ़ा	ailfa
ऐश	aish
ऐशट्रे	aishatre
ऐशबाग	aishabaag
ऐश्वर्य	aishvary
ऐश्वर्यशाली	aishvaryashaalee
ऐश्वर्यहीन	aishvaryaheen
ऐश्वर्या	aishvarya
ऐस	ais
ऐसा	aisa
ऐसिटाइल	aisitail
ऐसिड	aisid
ऐसिडोफ़ाइल	aisidofail
ऐसिडोफ़िल	aisidofil
ऐसिडोफ़िलीय	aisidofileey
ऐसी	aisee
ऐसीटिक	aiseetik
ऐसीटेट	aiseetet
ऐसीटोन	aiseeton
ऐसे	aise
ऐसो	aiso
ऐसोसिएशन	aisosieshan
ऐस्किनैंथस	aiskinainthas
ऐस्कीई	aiskeeee
ऐस्टर	aistar
ऐस्प	aisp
ऐस्पैरागस	aispairaagas
ऐस्बेटस	aisbetas
ऐस्बेस्टसिस	aisbestasis
ऐहलौकिक	aihalaukik
ऐहिकता	aihikata
ऐहोल	aihol
ऐज़	aiz
ऐफ़्रो	aifro
ऑ	o
ऑंख	onkh
ऑंधी	ondhee
ऑइल	oil
ऑक	ok
ऑकलैंड	okalaind
ऑक्टेन	okten
ऑक्टोपस	oktopas
ऑक्सफोर्ड	oksaphord
ऑक्सब्रिज	oksabrij
ऑक्साइड	oksaid
ऑक्साइडों	oksaidon
ऑक्सिजन	oksijan
ऑक्सिडेंटल	oksidental
ऑक्सीकरण	okseekaran
ऑक्सीकारक	okseekaarak
ऑक्सीकृत	okseekrt
ऑक्सीजन	okseejan
ऑक्सीजीव	okseejeev
ऑक्सीटोसिन	okseetosin
ऑक्सीडेंट	okseedent
ऑक्सीबेन्ज़ीन	okseebenzeen
ऑक्सौन	oksaun
ऑक्स्फ़ोर्ड	oksford
ऑक्सफ़र्ड	oksafard
ऑक्सफ़ोर्ड	oksaford
ऑटम	otam
ऑटो	oto
ऑटोनोमिक	otonomik
ऑटोमेटेड	otometed
ऑटोमेशन	otomeshan
ऑटोमैट	otomait
ऑटोमैटिक	otomaitik
ऑटोमोटिव	otomotiv
ऑटोमोबाइल	otomobail
ऑटोरिक्शा	otoriksha
ऑडिटर	oditar
ऑडिटिंग	oditing
ऑडियो	odiyo
ऑडिशन	odishan
ऑडी	odee
ऑड्रे	odre
ऑथरिंग	otharing
ऑथोरिटी	othoritee
ऑनर्स	onars
ऑनलाइन	onalain
ऑनलाईन	onalaeen
ऑनस्क्रीन	onaskreen
ऑन्कोलॉजी	onkolojee
ऑप	op
ऑपरेट	oparet
ऑपरेटर	oparetar
ऑपरेटरों	oparetaron
ऑपरेटर्स	oparetars
ऑपरेटिंग	opareting
ऑपरेटिव	oparetiv
ऑपरेशंस	opareshans
ऑपरेशन	opareshan
ऑपरेशनल	opareshanal
ऑपरेशनों	opareshanon
ऑपरेशन्स	opareshans
ऑपेरा	opera
ऑपोज़म	opozam
ऑप्टिक	optik
ऑप्टिकल	optikal
ऑप्टिक्स	optiks
ऑप्शन	opshan
ऑफ	oph
ऑफर	ophar
ऑफलाइन	ophalain
ऑफसेट	ophaset
ऑफिशियल	ophishiyal
ऑफिस	ophis
ऑफिसर	ophisar
ऑफिसियल	ophisiyal
ऑब	ob
ऑबर्न	obarn
ऑब्जेक्ट	objekt
ऑब्जेक्टिव	objektiv
ऑब्जेक्ट्स	objekts
ऑमलेट	omalet
ऑयल	oyal
ऑरलैंडो	oralaindo
ऑरवेल	oravel
ऑरिगैनो	origaino
ऑरेंज	orenj
ऑरेकल	orekal
ऑरेगॉन	oregon
ऑर्किड	orkid
ऑर्कुट	orkut
ऑर्केस्ट्रा	orkestra
ऑर्ग	org
ऑर्गन	organ
ऑर्गनाइजेशन	organaijeshan
ऑर्गेनाइजेशन	orgenaijeshan
ऑर्डर	ordar
ऑर्डिनल्स	ordinals
ऑर्थोडॉक्स	orthodoks
ऑर्बिट	orbit
ऑर्बिटर	orbitar
ऑल	ol
ऑलंपिक	olampik
ऑलराउंडर	olaraundar
ऑलिवर	olivar
ऑल्टो	olto
ऑवर	ovar
ऑस्कर	oskar
ऑस्टिन	ostin
ऑस्टियोपोरोसिस	ostiyoporosis
ऑस्टेन	osten
ऑस्ट्रिया	ostriya
ऑस्ट्रियाई	ostriyaee
ऑस्ट्रेलियन	ostreliyan
ऑस्ट्रेलिया	ostreliya
ऑस्ट्रेलियाई	ostreliyaee
ऑस्ट्रेलेशिया	ostreleshiya
ऑस्ट्रो	ostro
ऑज़ार्क	ozaark
ऑफ़िसर	ofisar
ओं	on
ओंकार	onkaar
ओंकारनाथ	onkaaranaath
ओंकारा	omkara
ओंकारेश्वर	onkaareshvar
ओंकोजीन	onkojeen
ओंटारियो	ontaariyo
ओंठ	onth
ओंठों	onthon
ओआरजी	oaarajee
ओइलर	oilar
ओईसीडी	oeeseedee
ओऍस	oais
ओएनजीसी	oenajeesee
ओएस	oes
ओएसिस	oesis
ओक	ok
ओकटाइन	okatain
ओकटेट	okatet
ओकना	okana
ओकर	okar
ओकलाहोमा	okalaahoma
ओकलैंड	okalaind
ओकल्टीज़्म	okalteezm
ओका	oka
ओकिनावा	okinaava
ओकुलर	okular
ओके	oke
ओक्लाहोमा	oklaahoma
ओक्स	oks
ओखला	okhala
ओखली	okhalee
ओखा	okha
ओगारना	ogaarana
ओघ	ogh
ओचित्यपूर्ण	ochityapoorn
ओछा	ochha
ओछापन	ochhaapan
ओज	oj
ओजना	ojana
ओजपूर्ण	ojapoorn
ओजस	ojas
ओजस्विता	ojasvita
ओजस्विनी	ojasvinee
ओजस्वी	ojasvee
ओजहीन	ojaheen
ओजोन	ojon
ओजोनियम	ojoniyam
ओझ	ojh
ओझल	ojhal
ओझा	ojha
ओझाइन	ojhain
ओझड़ी	ojhadee
ओट	ot
ओटना	otana
ओटनी	otanee
ओटागो	otaago
ओटावा	otaava
ओटिटिस	otitis
ओटी	otee
ओटो	oto
ओटोमन	otoman
ओट्टो	otto
ओठ	oth
ओड	od
ओडिया	odiya
ओडिशा	odisha
ओडिसी	odisee
ओडीआई	odeeaee
ओडीशा	odeesha
ओडोमीटर	odomeetar
ओढना	odhana
ओढनी	odhanee
ओणम	onam
ओतप्रोत	otaprot
ओथडोटिस	othadotis
ओदन	odan
ओदा	oda
ओध	odh
ओधे	odhe
ओन	on
ओनगा	onaga
ओनर्स	onars
ओनली	onalee
ओना	ona
ओनाग्रेसी	onaagresee
ओनिडा	onida
ओनीक्स	oneeks
ओन्ली	onlee
ओप	op
ओपन	opan
ओपनर	opanar
ओपनिंग	opaning
ओपनी	opanee
ओपरा	opara
ओपल	opal
ओपस्सम	opassam
ओपिनियन	opiniyan
ओपी	opee
ओपीवी	opeevee
ओपेक	opek
ओपेन	open
ओपेरा	opera
ओप्टामीटर	optaameetar
ओब	ob
ओबडाया	obadaaya
ओबरा	obara
ओबामा	obaama
ओबिलिस्क	obilisk
ओबी	obee
ओबीसी	obeesee
ओबेराय	oberaay
ओबेरॉन	oberon
ओबेरॉय	oberoy
ओबेसिटी	obesitee
ओबो	obo
ओब्लास्ट	oblaast
ओब्लास्त	oblaast
ओम	om
ओमकारा	omkara
ओमप्रकाश	omaprakaash
ओमर	omar
ओमा	oma
ओमान	omaan
ओमाहा	omaaha
ओमी	omee
ओमेगा	omega
ओमोउलु	omoulu
ओम्कारेश्वर	omkaareshvar
ओयूपी	oyoopee
ओर	or
ओरंग	orang
ओरछा	orachha
ओरटोरिओ	oratorio
ओरल	oral
ओरलैंडो	oralaindo
ओरायन	oraayan
ओरिएंट	orient
ओरिएंटल	oriental
ओरिएंटेड	oriented
ओरिएंटेशन	orienteshan
ओरिजिन	orijin
ओरिजिनल	orijinal
ओरियन	oriyan
ओरियल	oriyal
ओरिस	oris
ओरी	oree
ओरे	ore
ओरेंज	orenj
ओरेकल	orekal
ओरेगन	oregan
ओरेगोन	oregon
ओरैंग	oraing
ओरैंगुटान	oraingutaan
ओरैंगुटान्ग	oraingutaang
ओर्थपेडीक	orthapedeek
ओर्थोगोनल	orthogonal
ओर्स्टेड	orsted
ओल	ol
ओलंपिक	olampik
ओलंपिक्स	olampiks
ओलंपिया	olampiya
ओलंपियाड	olampiyaad
ओलती	olatee
ओलम्पिक	olampik
ओलम्पियाड	olampiyaad
ओला	ola
ओलावृष्टि	olaavrshti
ओलिंपिक	olimpik
ओलिंपिक्स	olimpiks
ओलिंपियन	olimpiyan
ओलिंपियाड	olimpiyaad
ओलिंपियाडअ	olimpiyaad
ओलिक	olik
ओलिम्पिक	olimpik
ओलियंडर	oliyandar
ओलियम	oliyam
ओलिया	oliya
ओलिव	oliv
ओलिवर	olivar
ओलिविया	oliviya
ओले	ole
ओलों	olon
ओल्गा	olga
ओल्ड	old
ओवन	ovan
ओवर	ovar
ओवरआल	ovaraal
ओवरऑल	ovarol
ओवरकोट	ovarakot
ओवरचर	ovarachar
ओवरटाइम	ovarataim
ओवरटेक	ovaratek
ओवरडोज	ovaradoj
ओवरड्राफ्ट	ovaradraapht
ओवरबुक	ovarabuk
ओवरब्रिज	ovarabrij
ओवरराइड	ovararaid
ओवरले	ovarale
ओवरलैप	ovaralaip
ओवरलोड	ovaralod
ओवरसियर	ovarasiyar
ओवरसीज	ovaraseej
ओवरहाल	ovarahaal
ओवरहेड	ovarahed
ओवरहॉल	ovarahol
ओवरों	ovaron
ओवर्स	ovars
ओवल	oval
ओवेन	oven
ओवोफ़्लाविन	ovoflaavin
ओशन	oshan
ओशिनिया	oshiniya
ओशेनिया	osheniya
ओशो	osho
ओषधि	oshadhi
ओषधियाँ	oshadhiyaan
ओष्ठहीन	oshthaheen
ओष्ठी	oshthee
ओस	os
ओसबोर्न	osaborn
ओसर	osar
ओसवाल	osavaal
ओसांक	osaank
ओसाका	osaaka
ओसामा	osaama
ओसारा	osaara
ओसारी	osaaree
ओसियां	osiyaan
ओसिरिस	osiris
ओसेतिया	osetiya
ओस्टवाल्ड	ostavaald
ओस्मानाबाद	osmaanaabaad
ओस्मियम	osmiyam
ओस्लो	oslo
ओह	oh
ओहदा	ohada
ओहदे	ohade
ओहदेदार	ohadedaar
ओहरी	oharee
ओहायो	ohaayo
ओहियो	ohiyo
ओही	ohee
ओहो	oho
ओह्म	ohm
ओज़ोकेराइट	ozokerait
ओज़ोन	ozon
ओड़िया	odiya
ओड़िशा	odisha
ओड़िसा	odisa
ओढ़कर	odhakar
ओढ़ना	odhana
ओढ़नी	odhanee
ओफ़	of
औ	au
औंधा	aundha
औंधाना	aundhaana
औंधे	aundhe
औंस	auns
औक	auk
औकात	aukaat
औक्स	auks
औघड़	aughad
औचक	auchak
औचित्य	auchity
औचित्यपूर्ण	auchityapoorn
औचित्यपूर्णता	auchityapoornata
औछा	auchha
औज	auj
औजार	aujaar
औजारों	aujaaron
औट	aut
औटन	autan
औटना	autana
औटपाय	autapaay
औत्कर्ष्य	autkarshy
औत्पत्तिक	autpattik
औत्सर्गिक	autsargik
औदरीय	audareey
औदसा	audasa
औदात्य	audaaty
औदार्य	audaary
औदार्यवाद	audaaryavaad
औदीच्य	audeechy
औद्यानिकी	audyaanikee
औद्योगिक	audyogik
औद्योगिकता	audyogikata
औद्योगिकरण	audyogikaran
औद्योगिकी	audyogikee
औद्योगिकीकरण	audyogikeekaran
औद्योगीकरण	audyogeekaran
औद्योगीकृत	audyogeekrt
औद्यौगिक	audyaugik
औधान	audhaan
औनिप	aunip
औपचारिक	aupachaarik
औपचारिकता	aupachaarikata
औपचारिकताएँ	aupachaarikataen
औपचारिकताओं	aupachaarikataon
औपचारिकतायें	aupachaarikataayen
औपनिवेशिक	aupaniveshik
औपनिवेशीकरण	aupanivesheekaran
औपन्यासिक	aupanyaasik
औपबंधिक	aupabandhik
औपरीतल	aupareetal
औपसर्गिक	aupasargik
औप्चारिक	aupchaarik
औप्बधिक	aupbadhik
औफ	auph
औफिस	auphis
औबेक्स	aubeks
और	aur
औरंगजेब	aurangajeb
औरंगाबाद	aurangaabaad
औरंगज़ेब	aurangazeb
औरगंजेब	auraganjeb
औरत	aurat
औरताना	aurataana
औरते	aurate
औरतें	auraten
औरतों	auraton
औरसी	aurasee
औरा	aura
औराई	auraee
औरिगन	aurigan
औरेब	aureb
औरैया	auraiya
औरों	auron
औरोरा	aurora
और्	aur
और्व	aurv
और्वा	aurva
औलाद	aulaad
औलिया	auliya
औली	aulee
औषध	aushadh
औषधज्ञ	aushadhagy
औषधालय	aushadhaalay
औषधालयों	aushadhaalayon
औषधि	aushadhi
औषधियाँ	aushadhiyaan
औषधियां	aushadhiyaan
औषधियों	aushadhiyon
औषधी	aushadhee
औषधीय	aushadheey
औषधों	aushadhon
औसत	ausat
औसतन	ausatan
औसती	ausatee
औसना	ausana
औसर	ausar
औहदा	auhada
औज़ार	auzaar
औज़ारों	auzaaron
क	ka
कँगूरा	kangoora
कँटिया	kantiya
कँपाना	kanpaana
कँवर	kanvar
कँवल	kanval
कंकर	kankar
कंकरीट	kankareet
कंकाल	kankaal
कंकाली	kankaalee
कंकालीय	kankaaleey
कंकालों	kankaalon
कंक्रीट	kankreet
कंकड़	kankad
कंकड़दार	kankadadaar
कंकड़ीला	kankadeela
कंगन	kangan
कंगना	kangana
कंगनी	kanganee
कंगर	kangar
कंगारु	kangaaru
कंगारुओं	kangaaruon
कंगारू	kangaaroo
कंगाल	kangaal
कंगाली	kangaalee
कंगुरा	kangura
कंगूरेदार	kangooredaar
कंघा	kangha
कंघी	kanghee
कंचन	kanchan
कंचनजंगा	kanchanajanga
कंचनजंघा	kanchanajangha
कंचनपुर	kanchanapur
कंचा	kancha
कंची	kanchee
कंचुक	kanchuk
कंचुकपक्ष	kanchukapaksh
कंचे	kanche
कंचेरा	kanchera
कंजर	kanjar
कंजर्वेटिव	kanjarvetiv
कंजाक्तिवा	kanjaaktiva
कंजूम	kanjoom
कंजूस	kanjoos
कंजूसी	kanjoosee
कंज्यूमर	kanjyoomar
कंट	kant
कंटक	kantak
कंटकबन	kantakaban
कंटकहीन	kantakaheen
कंटिया	kantiya
कंटेंट	kantent
कंटेनर	kantenar
कंटेनरीकृत	kantenareekrt
कंटेनरों	kantenaron
कंट्रास्ट	kantraast
कंट्री	kantree
कंट्रीवाइड	kantreevaid
कंट्रोल	kantrol
कंट्रोलर	kantrolar
कंट्रोल्स	kantrols
कंठ	kanth
कंठच्छेद	kanthachchhed
कंठनाली	kanthanaalee
कंठलंगोट	kanthalangot
कंठस्थ	kanthasth
कंठहार	kanthahaar
कंठी	kanthee
कंडक्टर	kandaktar
कंडी	kandee
कंडीशन	kandeeshan
कंडीशनर	kandeeshanar
कंडीशनिंग	kandeeshaning
कंडेनसेशन	kandenaseshan
कंडोम	kandom
कंत	kant
कंतूस	kantoos
कंद	kand
कंदकारी	kandakaaree
कंदर	kandar
कंदरा	kandara
कंदराओं	kandaraon
कंदरान्वेषक	kandaraanveshak
कंदरिया	kandariya
कंदर्प	kandarp
कंदहार	kandahaar
कंदील	kandeel
कंदुक	kanduk
कंधा	kandha
कंधार	kandhaar
कंधे	kandhe
कंधों	kandhon
कंप	kamp
कंपकंपी	kampakampee
कंपकपी	kampakapee
कंपन	kampan
कंपना	kampana
कंपनिक	kampanik
कंपनियाँ	kampaniyaan
कंपनियां	kampaniyaan
कंपनियों	kampaniyon
कंपनी	kampanee
कंपनों	kampanon
कंपा	kampa
कंपाइलर	kampailar
कंपाना	kampaana
कंपायमान	kampaayamaan
कंपार्टमेंट	kampaartament
कंपास	kampaas
कंपिका	kampika
